Rk,Player,Pos,Age,Tm,G,GS,MP,FG,FGA,FG%,3P,3PA,3P%,2P,2PA,2P%,eFG%,FT,FTA,FT%,ORB,DRB,TRB,AST,STL,BLK,TOV,PF,PTS
1,Alex Abrines\abrinal01,SG,24,OKC,50,5,775,77,197,.391,54,144,.375,23,53,.434,.528,32,37,.865,17,62,79,19,27,5,21,88,240
2,Quincy Acy\acyqu01,PF,27,BRK,49,6,980,86,255,.337,66,198,.333,20,57,.351,.467,42,52,.808,32,173,205,33,23,16,50,101,280
3,Steven Adams\adamsst01,C,24,OKC,51,51,1647,304,482,.631,0,2,.000,304,480,.633,.631,100,170,.588,265,196,461,48,63,49,79,146,708
4,Bam Adebayo\adebaba01,C,20,MIA,46,11,934,123,222,.554,0,6,.000,123,216,.569,.554,82,115,.713,78,165,243,74,27,30,42,94,328
5,Arron Afflalo\afflaar01,SG,32,ORL,40,2,502,43,115,.374,16,45,.356,27,70,.386,.443,16,20,.800,3,48,51,21,2,7,15,43,118
6,Cole Aldrich\aldrico01,C,29,MIN,12,0,28,3,9,.333,0,0,,3,9,.333,.333,2,4,.500,3,4,7,1,2,1,1,6,8
7,LaMarcus Aldridge\aldrila01,C,32,SAS,53,53,1800,469,940,.499,25,76,.329,444,864,.514,.512,226,271,.834,179,270,449,106,29,63,83,120,1189
8,Jarrett Allen\allenja01,C,19,BRK,47,6,857,143,247,.579,3,9,.333,140,238,.588,.585,65,84,.774,88,146,234,29,21,39,44,93,354
9,Kadeem Allen\allenka01,PG,25,BOS,7,0,27,1,6,.167,0,3,.000,1,3,.333,.167,3,4,.750,1,2,3,1,1,0,3,2,5
10,Tony Allen\allento01,SF,36,NOP,22,0,273,44,91,.484,4,12,.333,40,79,.506,.505,11,21,.524,20,27,47,9,11,3,19,49,103
11,Al-Farouq Aminu\aminual01,PF,27,POR,42,40,1266,146,362,.403,81,205,.395,65,157,.414,.515,34,46,.739,50,261,311,47,38,28,43,76,407
12,Justin Anderson\anderju01,SF,24,PHI,23,0,322,50,113,.442,18,55,.327,32,58,.552,.522,16,22,.727,17,39,56,13,11,4,7,36,134
13,Kyle Anderson\anderky01,SF,24,SAS,48,42,1311,148,288,.514,11,32,.344,137,256,.535,.533,71,89,.798,53,226,279,130,67,37,63,71,378
14,Ryan Anderson\anderry01,PF,29,HOU,51,50,1430,172,399,.431,107,282,.379,65,117,.556,.565,61,77,.792,77,196,273,50,22,16,40,96,512
15,Ike Anigbogu\anigbik01,C,19,IND,10,0,28,4,9,.444,0,0,,4,9,.444,.444,5,6,.833,5,4,9,0,1,3,2,1,13
16,Giannis Antetokounmpo\antetgi01,PF,23,MIL,49,49,1810,499,922,.541,25,82,.305,474,840,.564,.555,344,453,.759,108,400,508,231,72,62,136,146,1367
17,Carmelo Anthony\anthoca01,PF,33,OKC,54,54,1738,343,833,.412,109,314,.347,234,519,.451,.477,121,156,.776,39,284,323,76,34,35,69,142,916
18,OG Anunoby\anunoog01,SF,20,TOR,54,42,1145,120,268,.448,55,159,.346,65,109,.596,.550,33,46,.717,35,99,134,44,46,8,32,98,328
19,Ryan Arcidiacono\arcidry01,PG,23,CHI,9,0,90,4,9,.444,2,7,.286,2,2,1.000,.556,2,2,1.000,0,4,4,9,4,0,1,8,12
20,Trevor Ariza\arizatr01,SF,32,HOU,44,44,1538,179,422,.424,120,313,.383,59,109,.541,.566,53,60,.883,24,181,205,71,67,8,40,84,531
21,Darrell Arthur\arthuda01,PF,29,DEN,11,1,98,13,34,.382,5,17,.294,8,17,.471,.456,1,1,1.000,2,10,12,7,5,1,12,12,32
22,Jamel Artis\artisja01,SG,25,ORL,5,0,55,4,17,.235,0,5,.000,4,12,.333,.235,1,3,.333,1,6,7,4,0,0,0,0,9
23,Omer Asik\asikom01,C,31,NOP,14,0,121,7,16,.438,0,0,,7,16,.438,.438,4,12,.333,7,30,37,2,1,2,5,14,18
24,D.J. Augustin\augusdj01,PG,30,ORL,47,8,975,128,295,.434,61,152,.401,67,143,.469,.537,97,115,.843,17,68,85,150,39,0,63,57,414
25,Luke Babbitt\babbilu01,SF,28,ATL,37,9,570,80,168,.476,49,111,.441,31,57,.544,.622,17,22,.773,5,76,81,26,7,5,15,47,226
26,Dwayne Bacon\bacondw01,SG,22,CHO,33,6,463,41,115,.357,10,32,.313,31,83,.373,.400,10,14,.714,1,89,90,20,9,2,15,37,102
27,Ron Baker\bakerro01,SG,24,NYK,29,1,385,20,59,.339,11,33,.333,9,26,.346,.432,20,26,.769,5,25,30,47,26,6,18,33,71
28,Lonzo Ball\balllo01,PG,20,LAL,36,36,1222,142,399,.356,59,195,.303,83,204,.407,.430,24,50,.480,48,209,257,255,55,32,98,78,367
29,J.J. Barea\bareajo01,PG,33,DAL,51,2,1174,209,501,.417,80,230,.348,129,271,.476,.497,72,92,.783,9,146,155,304,26,3,98,68,570
30,Harrison Barnes\barneha02,PF,25,DAL,53,53,1841,367,815,.450,73,210,.348,294,605,.486,.495,168,204,.824,59,292,351,101,36,12,81,67,975
31,Will Barton\bartowi01,SG,27,DEN,53,19,1695,283,644,.439,95,263,.361,188,381,.493,.513,108,141,.766,43,212,255,218,58,32,98,100,769
32,Nicolas Batum\batumni01,SG,29,CHO,40,40,1270,180,429,.420,59,185,.319,121,244,.496,.488,68,85,.800,35,142,177,189,41,12,84,51,487
33,Jerryd Bayless\bayleje01,SG,29,PHI,38,11,916,109,261,.418,54,145,.372,55,116,.474,.521,35,44,.795,15,64,79,53,23,6,46,90,307
34,Aron Baynes\baynear01,C,31,BOS,56,43,1020,135,289,.467,0,8,.000,135,281,.480,.467,48,64,.750,82,215,297,52,16,34,54,135,318
35,Kent Bazemore\bazemke01,SG,28,ATL,55,55,1533,243,582,.418,90,235,.383,153,347,.441,.495,137,172,.797,22,198,220,196,91,40,134,126,713
36,Bradley Beal\bealbr01,SG,24,WAS,55,55,1996,475,1032,.460,135,362,.373,340,670,.507,.526,220,278,.791,44,204,248,227,65,25,131,102,1305
37,Malik Beasley\beaslma01,SG,21,DEN,45,0,459,56,140,.400,18,62,.290,38,78,.487,.464,15,23,.652,13,49,62,25,12,4,20,33,145
38,Michael Beasley\beaslmi01,PF,29,NYK,49,8,971,252,493,.511,18,48,.375,234,445,.526,.529,95,123,.772,64,189,253,64,24,27,95,88,617
39,Marco Belinelli\belinma01,SG,31,ATL,52,1,1210,199,484,.411,92,247,.372,107,237,.451,.506,101,109,.927,13,86,99,103,46,3,54,41,591
40,Jordan Bell\belljo01,C,23,GSW,38,11,546,87,131,.664,0,3,.000,87,128,.680,.664,20,30,.667,46,103,149,68,26,40,38,72,194
41,DeAndre' Bembry\bembrde01,SF,23,ATL,18,0,311,33,88,.375,7,20,.350,26,68,.382,.415,14,21,.667,7,34,41,26,13,8,36,30,87
42,Dragan Bender\bendedr01,PF,20,PHO,56,11,1286,117,304,.385,78,205,.380,39,99,.394,.513,21,27,.778,21,186,207,73,14,31,69,104,333
43,Davis Bertans\bertada01,PF,25,SAS,52,4,760,111,258,.430,65,178,.365,46,80,.575,.556,28,33,.848,14,96,110,48,16,19,26,63,315
44,Patrick Beverley\beverpa01,SG,29,LAC,11,11,334,48,119,.403,24,60,.400,24,59,.407,.504,14,17,.824,16,29,45,32,19,5,25,34,134
45,Khem Birch\birchkh01,C,25,ORL,18,0,196,27,50,.540,0,0,,27,50,.540,.540,8,14,.571,28,36,64,11,7,10,11,25,62
46,Jabari Bird\birdja01,SG,23,BOS,4,0,22,1,4,.250,0,2,.000,1,2,.500,.250,3,5,.600,0,2,2,1,1,0,0,2,5
47,Bismack Biyombo\biyombi01,C,25,ORL,54,20,1039,119,222,.536,0,1,.000,119,221,.538,.536,72,107,.673,97,221,318,35,15,73,61,115,310
48,Nemanja Bjelica\bjeline01,PF,29,MIN,42,4,661,94,190,.495,42,96,.438,52,94,.553,.605,21,25,.840,23,109,132,35,25,5,26,75,251
49,Tarik Black\blackta01,C,26,HOU,35,0,348,52,91,.571,0,8,.000,52,83,.627,.571,21,45,.467,43,60,103,8,13,18,27,73,125
50,Antonio Blakeney\blakean01,SG,21,CHI,12,0,170,30,82,.366,9,30,.300,21,52,.404,.421,16,21,.762,3,17,20,7,2,0,8,8,85
51,Eric Bledsoe\bledser01,PG,28,TOT,45,45,1370,271,607,.446,68,221,.308,203,386,.526,.502,154,200,.770,30,131,161,190,93,24,128,109,764
51,Eric Bledsoe\bledser01,PG,28,PHO,3,3,83,16,40,.400,4,13,.308,12,27,.444,.450,11,14,.786,3,4,7,9,4,2,10,6,47
51,Eric Bledsoe\bledser01,PG,28,MIL,42,42,1287,255,567,.450,64,208,.308,191,359,.532,.506,143,186,.769,27,127,154,181,89,22,118,103,717
52,Vander Blue\blueva01,SG,25,LAL,5,0,45,1,5,.200,0,2,.000,1,3,.333,.200,1,2,.500,0,1,1,3,1,0,3,2,3
53,Bogdan Bogdanovic\bogdabo01,SG,25,SAC,50,25,1351,208,444,.468,76,192,.396,132,252,.524,.554,66,78,.846,18,115,133,153,50,12,83,105,558
54,Bojan Bogdanovic\bogdabo02,SF,28,IND,54,54,1642,261,558,.468,101,261,.387,160,297,.539,.558,109,129,.845,16,157,173,76,41,3,64,90,732
55,Andrew Bogut\bogutan01,C,33,LAL,24,5,216,17,25,.680,0,0,,17,25,.680,.680,2,2,1.000,26,52,78,15,4,13,19,40,36
56,Joel Bolomboy\bolomjo01,PF,24,MIL,6,0,38,3,6,.500,0,1,.000,3,5,.600,.500,3,6,.500,6,4,10,0,2,0,2,3,9
57,Devin Booker\bookede01,SG,21,PHO,43,43,1463,347,805,.431,112,294,.381,235,511,.460,.501,231,258,.895,19,171,190,210,40,11,154,131,1037
58,Trevor Booker\booketr01,PF,30,TOT,44,5,777,125,238,.525,3,15,.200,122,223,.547,.532,53,77,.688,76,144,220,58,21,14,45,79,306
58,Trevor Booker\booketr01,PF,30,BRK,18,5,395,77,150,.513,3,12,.250,74,138,.536,.523,24,43,.558,38,81,119,38,8,5,30,43,181
58,Trevor Booker\booketr01,PF,30,PHI,26,0,382,48,88,.545,0,3,.000,48,85,.565,.545,29,34,.853,38,63,101,20,13,9,15,36,125
59,Avery Bradley\bradlav01,SG,27,TOT,42,42,1328,243,589,.413,74,198,.374,169,391,.432,.475,61,80,.763,21,78,99,89,49,7,96,85,621
59,Avery Bradley\bradlav01,SG,27,DET,40,40,1268,233,570,.409,74,194,.381,159,376,.423,.474,61,80,.763,19,75,94,83,46,7,93,80,601
59,Avery Bradley\bradlav01,SG,27,LAC,2,2,60,10,19,.526,0,4,.000,10,15,.667,.526,0,0,,2,3,5,6,3,0,3,5,20
60,Tony Bradley\bradlto01,C,20,UTA,8,0,28,3,11,.273,0,1,.000,3,10,.300,.273,2,2,1.000,4,7,11,1,0,0,0,1,8
61,Corey Brewer\breweco01,SF,31,LAL,50,2,634,71,158,.449,8,43,.186,63,115,.548,.475,29,45,.644,20,67,87,36,38,8,35,77,179
62,Malcolm Brogdon\brogdma01,PG,25,MIL,46,20,1404,238,489,.487,59,156,.378,179,333,.538,.547,75,85,.882,23,129,152,149,41,13,65,128,610
63,Aaron Brooks\brookaa01,PG,33,MIN,26,1,157,22,51,.431,7,21,.333,15,30,.500,.500,4,6,.667,5,8,13,18,6,0,9,18,55
64,Dillon Brooks\brookdi01,SF,22,MEM,54,46,1514,187,413,.453,56,149,.376,131,264,.496,.521,54,75,.720,29,138,167,68,44,14,66,170,484
65,Bobby Brown\brownbo02,PG,33,HOU,20,0,115,19,58,.328,11,40,.275,8,18,.444,.422,1,2,.500,0,7,7,11,4,0,9,6,50
66,Jaylen Brown\brownja02,SF,21,BOS,51,51,1608,269,584,.461,90,232,.388,179,352,.509,.538,97,164,.591,49,227,276,82,52,20,89,147,725
67,Lorenzo Brown\brownlo01,PG,27,TOR,12,0,95,7,21,.333,0,7,.000,7,14,.500,.333,0,0,,0,10,10,12,3,0,1,5,14
68,Markel Brown\brownma02,SG,26,HOU,2,0,21,1,4,.250,0,3,.000,1,1,1.000,.250,0,0,,1,3,4,0,0,0,1,4,2
69,Sterling Brown\brownst02,SG,22,MIL,28,2,400,45,104,.433,18,45,.400,27,59,.458,.519,12,14,.857,13,59,72,8,23,7,13,41,120
70,Nicolas Brussino\brussni01,SF,24,ATL,4,0,10,0,2,.000,0,2,.000,0,0,,.000,0,0,,0,3,3,0,0,0,0,0,0
71,Thomas Bryant\bryanth01,C,20,LAL,6,0,19,2,6,.333,1,4,.250,1,2,.500,.417,2,4,.500,1,2,3,2,0,0,0,0,7
72,Reggie Bullock\bullore01,SF,26,DET,38,28,961,130,253,.514,63,140,.450,67,113,.593,.638,14,21,.667,13,66,79,46,32,7,18,44,337
73,Trey Burke\burketr01,PG,25,NYK,11,0,156,39,71,.549,7,16,.438,32,55,.582,.599,9,14,.643,2,12,14,34,3,0,7,8,94
74,Alec Burks\burksal01,SG,26,UTA,48,1,900,150,364,.412,40,121,.331,110,243,.453,.467,102,118,.864,17,146,163,57,34,8,46,66,442
75,Jimmy Butler\butleji01,SG,28,MIN,51,51,1894,385,800,.481,64,170,.376,321,630,.510,.521,304,352,.864,69,207,276,258,100,20,98,67,1138
76,Dwight Buycks\buyckdw01,PG,28,DET,15,0,234,48,104,.462,9,23,.391,39,81,.481,.505,18,21,.857,5,21,26,35,8,2,23,24,123
77,Bruno Caboclo\cabocbr01,SF,22,TOR,2,0,7,0,2,.000,0,2,.000,0,0,,.000,0,0,,0,1,1,1,1,0,0,1,0
78,Jose Calderon\caldejo01,PG,36,CLE,37,24,586,50,102,.490,26,58,.448,24,44,.545,.618,14,18,.778,8,42,50,73,19,0,24,52,140
79,Kentavious Caldwell-Pope\caldwke01,SG,24,LAL,46,46,1493,207,506,.409,90,253,.356,117,253,.462,.498,97,127,.764,38,179,217,91,73,10,59,83,601
80,Isaiah Canaan\canaais01,PG-SG,26,TOT,20,1,422,52,137,.380,22,66,.333,30,71,.423,.460,46,51,.902,6,39,45,76,16,1,29,36,172
80,Isaiah Canaan\canaais01,SG,26,HOU,1,0,4,0,1,.000,0,0,,0,1,.000,.000,0,0,,0,1,1,0,0,0,0,0,0
80,Isaiah Canaan\canaais01,PG,26,PHO,19,1,418,52,136,.382,22,66,.333,30,70,.429,.463,46,51,.902,6,38,44,76,16,1,29,36,172
81,Clint Capela\capelca01,C,23,HOU,48,48,1296,293,445,.658,0,1,.000,293,444,.660,.658,99,165,.600,151,366,517,50,37,88,75,129,685
82,DeMarre Carroll\carrode01,SF,31,BRK,51,51,1504,223,543,.411,93,263,.354,130,280,.464,.496,133,171,.778,80,248,328,97,45,20,76,111,672
83,Vince Carter\cartevi01,SF,41,SAC,34,4,565,62,161,.385,33,90,.367,29,71,.408,.488,14,21,.667,9,61,70,38,29,20,17,55,171
84,Michael Carter-Williams\cartemi01,PG,26,CHO,42,2,670,53,168,.315,11,44,.250,42,124,.339,.348,52,64,.813,32,79,111,96,32,16,42,84,169
85,Alex Caruso\carusal01,PG,23,LAL,23,0,309,25,60,.417,5,20,.250,20,40,.500,.458,7,12,.583,8,23,31,46,12,6,21,31,62
86,Omri Casspi\casspom01,SF,29,GSW,42,6,631,100,170,.588,9,18,.500,91,152,.599,.615,43,56,.768,24,143,167,44,17,18,33,62,252
87,Willie Cauley-Stein\caulewi01,C,24,SAC,48,35,1309,246,492,.500,2,11,.182,244,481,.507,.502,97,157,.618,81,243,324,105,51,43,71,113,591
88,Tyler Cavanaugh\cavanty01,PF,23,ATL,30,1,413,55,116,.474,26,71,.366,29,45,.644,.586,13,17,.765,34,65,99,25,9,3,11,50,149
89,Mario Chalmers\chalmma01,PG,31,MEM,48,7,1075,126,336,.375,39,142,.275,87,194,.448,.433,84,100,.840,11,121,132,151,60,9,83,130,375
90,Tyson Chandler\chandty01,C,35,PHO,41,41,1048,104,167,.623,0,0,,104,167,.623,.623,55,89,.618,126,266,392,48,14,25,54,101,263
91,Wilson Chandler\chandwi01,SF,30,DEN,48,45,1455,155,374,.414,46,143,.322,109,231,.472,.476,64,76,.842,66,176,242,93,24,24,66,93,420
92,Marquese Chriss\chrisma01,PF,20,PHO,48,41,1017,122,303,.403,38,131,.290,84,172,.488,.465,59,97,.608,42,206,248,60,35,47,65,142,341
93,Ian Clark\clarkia01,SG,26,NOP,47,1,790,107,248,.431,33,113,.292,74,135,.548,.498,23,34,.676,7,67,74,60,16,7,30,66,270
94,Jordan Clarkson\clarkjo01,SG,25,LAL,53,2,1256,299,667,.448,68,210,.324,231,457,.505,.499,105,132,.795,44,115,159,173,39,3,95,63,771
95,Gian Clavell\clavegi01,SG,24,DAL,7,0,64,6,18,.333,6,15,.400,0,3,.000,.500,2,2,1.000,1,6,7,3,2,0,2,8,20
96,Antonius Cleveland\clevean01,SG,23,DAL,13,0,81,4,14,.286,0,1,.000,4,13,.308,.286,2,4,.500,2,8,10,2,6,4,2,11,10
97,John Collins\collijo01,PF,20,ATL,49,4,1091,208,353,.589,6,17,.353,202,336,.601,.598,92,125,.736,134,211,345,49,31,55,67,141,514
98,Zach Collins\colliza01,C,20,POR,39,1,593,65,166,.392,19,57,.333,46,109,.422,.449,10,21,.476,27,102,129,28,12,19,31,84,159
99,Kyle Collinsworth\colliky01,SF,26,DAL,12,0,134,11,20,.550,2,3,.667,9,17,.529,.600,5,12,.417,4,24,28,10,8,0,6,16,29
100,Darren Collison\collida01,PG,30,IND,52,52,1574,245,495,.495,70,162,.432,175,333,.526,.566,104,116,.897,29,110,139,273,75,13,66,97,664
101,Nick Collison\collini01,PF,37,OKC,9,0,52,7,8,.875,0,0,,7,8,.875,.875,3,6,.500,3,10,13,3,0,0,4,5,17
102,Mike Conley\conlemi01,PG,30,MEM,12,12,373,64,168,.381,24,77,.312,40,91,.440,.452,53,66,.803,0,27,27,49,12,3,18,24,205
103,Pat Connaughton\connapa01,SG,25,POR,55,5,1090,129,295,.437,60,160,.375,69,135,.511,.539,35,41,.854,21,96,117,73,12,15,32,84,353
104,Quinn Cook\cookqu01,PG,24,GSW,11,2,104,13,29,.448,5,14,.357,8,15,.533,.534,1,1,1.000,2,10,12,17,0,0,3,9,32
105,Charles Cooke\cookech01,SG,23,NOP,7,0,20,2,9,.222,1,5,.200,1,4,.250,.278,1,2,.500,0,1,1,1,1,0,1,0,6
106,Jack Cooley\cooleja01,PF,26,SAC,1,0,2,0,1,.000,0,0,,0,1,.000,.000,2,2,1.000,0,1,1,1,0,0,0,0,2
107,Matt Costello\costema01,C,24,SAS,3,0,18,1,3,.333,0,0,,1,3,.333,.333,0,0,,1,6,7,0,0,2,1,5,2
108,DeMarcus Cousins\couside01,C,27,NOP,48,48,1737,406,864,.470,104,294,.354,302,570,.530,.530,294,394,.746,105,513,618,257,79,76,242,183,1210
109,Robert Covington\covinro01,PF,27,PHI,49,49,1594,216,522,.414,132,347,.380,84,175,.480,.540,78,91,.857,37,240,277,95,79,35,95,149,642
110,Allen Crabbe\crabbal01,SG,25,BRK,52,45,1508,211,542,.389,123,345,.357,88,197,.447,.503,77,91,.846,18,205,223,82,29,20,61,114,622
111,Torrey Craig\craigto01,SF,27,DEN,24,4,374,36,78,.462,10,36,.278,26,42,.619,.526,17,27,.630,22,48,70,17,8,6,10,37,99
112,Jamal Crawford\crawfja01,SG,37,MIN,55,0,1039,203,478,.425,66,195,.338,137,283,.484,.494,75,84,.893,9,55,64,129,28,7,60,60,547
113,Jordan Crawford\crawfjo02,SG,29,NOP,2,0,37,7,14,.500,4,5,.800,3,9,.333,.643,0,0,,2,1,3,9,0,1,4,6,18
114,Jae Crowder\crowdja01,SF,27,CLE,53,47,1346,157,376,.418,62,189,.328,95,187,.508,.500,78,92,.848,41,132,173,58,41,12,42,124,454
115,Dante Cunningham\cunnida01,SF,30,NOP,51,24,1117,99,225,.440,35,108,.324,64,117,.547,.518,20,36,.556,50,143,193,26,27,16,16,75,253
116,Stephen Curry\curryst01,PG,29,GSW,40,40,1320,342,694,.493,169,405,.417,173,289,.599,.615,233,255,.914,27,178,205,257,63,5,122,94,1086
117,Troy Daniels\danietr01,SG,26,PHO,56,3,1069,155,378,.410,126,307,.410,29,71,.408,.577,45,49,.918,7,63,70,32,12,3,36,101,481
118,Anthony Davis\davisan02,PF,24,NOP,47,47,1711,461,851,.542,32,93,.344,429,758,.566,.561,304,370,.822,116,382,498,118,57,101,100,96,1258
119,Deyonta Davis\davisde01,C,21,MEM,38,1,484,84,134,.627,0,0,,84,134,.627,.627,24,35,.686,42,92,134,19,10,27,22,70,192
120,Ed Davis\davised01,C,28,POR,55,0,1025,124,215,.577,0,0,,124,215,.577,.577,61,92,.663,135,253,388,29,26,41,47,138,309
121,Dewayne Dedmon\dedmode01,C,28,ATL,36,21,834,148,268,.552,26,69,.377,122,199,.613,.601,37,48,.771,65,202,267,53,15,24,49,105,359
122,Sam Dekker\dekkesa01,PF,23,LAC,47,1,676,92,199,.462,9,56,.161,83,143,.580,.485,29,43,.674,32,93,125,30,21,7,25,49,222
123,Malcolm Delaney\delanma01,PG,28,ATL,47,2,884,95,247,.385,38,106,.358,57,141,.404,.462,55,70,.786,8,78,86,138,27,4,59,72,283
124,Matthew Dellavedova\dellama01,PG,27,MIL,37,3,702,55,149,.369,29,77,.377,26,72,.361,.466,23,25,.920,13,50,63,142,14,0,48,67,162
125,Luol Deng\denglu01,SF,32,LAL,1,1,13,1,2,.500,0,0,,1,2,.500,.500,0,0,,0,0,0,1,1,0,1,0,2
126,DeMar DeRozan\derozde01,SG,28,TOR,54,54,1845,451,977,.462,62,184,.337,389,793,.491,.493,328,396,.828,42,176,218,276,64,16,120,97,1292
127,Cheick Diallo\diallch01,PF,21,NOP,26,0,199,35,64,.547,0,0,,35,64,.547,.547,16,21,.762,16,50,66,6,2,4,9,31,86
128,Gorgui Dieng\dienggo01,C,28,MIN,54,0,960,143,282,.507,13,45,.289,130,237,.549,.530,62,80,.775,68,176,244,56,39,25,43,97,361
129,Spencer Dinwiddie\dinwisp01,PG,24,BRK,55,45,1570,243,607,.400,107,314,.341,136,293,.464,.488,150,183,.820,28,152,180,366,42,18,85,128,743
130,Tyler Dorsey\dorsety01,SG,21,ATL,29,0,324,43,115,.374,23,62,.371,20,53,.377,.474,17,26,.654,6,40,46,29,6,2,9,17,126
131,Damyean Dotson\dotsoda01,SG,23,NYK,24,2,211,28,63,.444,8,28,.286,20,35,.571,.508,5,7,.714,4,31,35,12,5,1,4,15,69
132,Milton Doyle\doylemi01,SG,24,BRK,6,0,63,7,25,.280,2,13,.154,5,12,.417,.320,2,3,.667,2,7,9,4,2,1,2,3,18
133,PJ Dozier\doziepj01,PG,21,OKC,1,0,2,1,2,.500,0,0,,1,2,.500,.500,0,0,,0,1,1,0,0,0,0,1,2
134,Goran Dragic\dragigo01,PG,31,MIA,50,50,1596,326,736,.443,74,208,.356,252,528,.477,.493,144,189,.762,35,168,203,240,44,11,118,117,870
135,Larry Drew\drewla02,PG,27,PHI,3,0,15,1,7,.143,0,3,.000,1,4,.250,.143,0,0,,1,0,1,2,0,0,1,2,2
136,Andre Drummond\drumman01,C,24,DET,51,51,1692,307,564,.544,0,6,.000,307,558,.550,.544,154,250,.616,255,541,796,194,85,76,143,166,768
137,Jared Dudley\dudleja01,PF,32,PHO,29,0,417,28,76,.368,17,50,.340,11,26,.423,.480,18,20,.900,7,46,53,57,16,4,14,49,91
138,Kris Dunn\dunnkr01,PG,23,CHI,40,31,1185,231,534,.433,33,102,.324,198,432,.458,.463,52,74,.703,22,162,184,254,82,18,118,132,547
139,Kevin Durant\duranke01,PF,29,GSW,47,47,1628,433,837,.517,121,288,.420,312,549,.568,.590,235,265,.887,24,297,321,257,40,91,146,100,1222
140,Jarell Eddie\eddieja01,SF,26,BOS,2,0,6,0,1,.000,0,1,.000,0,0,,.000,0,0,,0,1,1,0,1,0,0,0,0
141,Henry Ellenson\ellenhe01,PF,21,DET,21,0,141,22,64,.344,9,26,.346,13,38,.342,.414,1,3,.333,5,33,38,8,3,0,9,11,54
142,Wayne Ellington\ellinwa01,SG,30,MIA,54,2,1424,200,490,.408,159,408,.390,41,82,.500,.570,45,54,.833,16,143,159,56,35,6,36,63,604
143,Joel Embiid\embiijo01,C,23,PHI,41,41,1299,340,698,.487,39,133,.293,301,565,.533,.515,253,321,.788,90,361,451,134,24,76,167,141,972
144,James Ennis\ennisja01,SF,27,MEM,45,14,1053,108,222,.486,30,84,.357,78,138,.565,.554,64,73,.877,53,104,157,49,32,12,38,81,310
145,Tyler Ennis\ennisty01,PG,23,LAL,33,11,367,44,116,.379,6,32,.188,38,84,.452,.405,13,18,.722,9,41,50,56,14,5,14,49,107
146,Jawun Evans\evansja01,PG,21,LAC,38,4,701,82,239,.343,13,49,.265,69,190,.363,.370,37,47,.787,8,69,77,91,34,6,42,82,214
147,Tyreke Evans\evansty01,PG,28,MEM,46,26,1430,329,719,.458,98,250,.392,231,469,.493,.526,143,179,.799,39,193,232,229,48,14,94,85,899
148,Kenneth Faried\farieke01,PF,28,DEN,32,7,461,76,148,.514,0,1,.000,76,147,.517,.514,36,51,.706,68,85,153,18,12,13,23,51,188
149,Derrick Favors\favorde01,C,26,UTA,51,51,1432,259,473,.548,7,30,.233,252,443,.569,.555,101,145,.697,125,243,368,70,41,48,67,112,626
150,Kay Felder\feldeka01,PG,22,TOT,15,0,137,20,68,.294,4,19,.211,16,49,.327,.324,11,12,.917,2,13,15,20,3,1,16,11,55
150,Kay Felder\feldeka01,PG,22,CHI,14,0,134,20,66,.303,4,18,.222,16,48,.333,.333,11,12,.917,1,13,14,20,3,1,15,11,55
150,Kay Felder\feldeka01,PG,22,DET,1,0,3,0,2,.000,0,1,.000,0,1,.000,.000,0,0,,1,0,1,0,0,0,1,0,0
151,Cristiano Felicio\feliccr01,C,25,CHI,30,0,390,47,80,.588,0,0,,47,80,.588,.588,20,34,.588,33,51,84,21,4,6,18,52,114
152,Raymond Felton\feltora01,PG,33,OKC,56,1,948,154,371,.415,48,139,.345,106,232,.457,.480,22,30,.733,19,94,113,145,33,9,51,54,378
153,Terrance Ferguson\fergute01,SG,19,OKC,41,12,511,42,114,.368,21,79,.266,21,35,.600,.461,5,6,.833,15,19,34,11,17,5,9,62,110
154,Yogi Ferrell\ferreyo01,SG,24,DAL,55,16,1605,206,474,.435,92,236,.390,114,238,.479,.532,62,78,.795,23,160,183,124,36,4,61,116,566
155,Dorian Finney-Smith\finnedo01,PF,24,DAL,8,1,94,10,22,.455,5,14,.357,5,8,.625,.568,1,2,.500,5,5,10,5,0,1,7,13,26
156,Bryn Forbes\forbebr01,SG,24,SAS,56,12,1170,166,391,.425,74,188,.394,92,203,.453,.519,31,51,.608,10,78,88,56,23,2,31,91,437
157,Evan Fournier\fournev01,SF,25,ORL,46,46,1491,298,649,.459,101,260,.388,197,389,.506,.537,125,143,.874,21,125,146,133,41,13,81,110,822
158,De'Aaron Fox\foxde01,PG,20,SAC,46,33,1234,196,478,.410,28,84,.333,168,394,.426,.439,87,120,.725,22,95,117,193,44,12,106,110,507
159,Tim Frazier\fraziti01,PG,27,WAS,42,11,650,54,132,.409,14,43,.326,40,89,.449,.462,14,20,.700,14,68,82,154,39,5,49,73,136
160,Channing Frye\fryech01,C,34,CLE,44,1,545,84,169,.497,30,90,.333,54,79,.684,.586,14,15,.933,10,101,111,28,16,12,18,54,212
161,Markelle Fultz\fultzma01,SG,19,PHI,4,0,76,9,27,.333,0,0,,9,27,.333,.333,6,12,.500,3,6,9,7,2,1,6,6,24
162,Danilo Gallinari\gallida01,SF,29,LAC,14,14,439,71,178,.399,24,76,.316,47,102,.461,.466,48,49,.980,5,62,67,32,9,3,19,20,214
163,Langston Galloway\gallola01,SG,26,DET,44,2,658,101,256,.395,62,168,.369,39,88,.443,.516,27,34,.794,10,61,71,50,25,5,15,35,291
164,Marc Gasol\gasolma01,C,33,MEM,53,53,1804,326,786,.415,76,229,.332,250,557,.449,.463,220,262,.840,65,384,449,207,37,79,145,131,948
165,Pau Gasol\gasolpa01,C,37,SAS,53,51,1326,208,448,.464,38,93,.409,170,355,.479,.507,112,143,.783,84,361,445,173,17,54,82,78,566
166,Rudy Gay\gayru01,PF,31,SAS,34,5,771,147,309,.476,23,69,.333,124,240,.517,.513,73,93,.785,46,130,176,51,27,22,54,62,390
167,Paul George\georgpa01,SF,27,OKC,53,53,1932,398,892,.446,171,401,.426,227,491,.462,.542,208,258,.806,48,244,292,157,118,28,146,155,1175
168,Marcus Georges-Hunt\georgma01,SG,23,MIN,34,0,195,16,41,.390,3,14,.214,13,27,.481,.427,8,16,.500,6,6,12,7,4,0,3,27,43
169,Taj Gibson\gibsota01,PF,32,MIN,57,57,1916,295,515,.573,7,30,.233,288,485,.594,.580,92,121,.760,143,278,421,75,49,43,61,145,689
170,Manu Ginobili\ginobma01,SG,40,SAS,42,0,868,140,312,.449,45,130,.346,95,182,.522,.521,65,75,.867,14,76,90,103,27,13,67,83,390
171,Rudy Gobert\goberru01,C,25,UTA,28,28,856,124,213,.582,0,0,,124,213,.582,.582,95,141,.674,76,197,273,35,19,68,54,76,343
172,Aaron Gordon\gordoaa01,PF,22,ORL,39,38,1325,261,584,.447,79,228,.346,182,356,.511,.515,117,163,.718,66,259,325,84,35,27,75,77,718
173,Eric Gordon\gordoer01,SG,29,HOU,48,24,1543,303,717,.423,147,438,.336,156,279,.559,.525,157,193,.813,19,96,115,119,33,15,99,83,910
174,Marcin Gortat\gortama01,C,33,WAS,55,55,1443,207,385,.538,0,0,,207,385,.538,.538,74,120,.617,127,311,438,98,30,41,70,120,488
175,Treveon Graham\grahatr01,SG,24,CHO,41,1,709,73,165,.442,31,70,.443,42,95,.442,.536,32,44,.727,31,60,91,42,22,1,21,71,209
176,Jerami Grant\grantje01,PF,23,OKC,55,1,1132,155,305,.508,18,73,.247,137,232,.591,.538,93,138,.674,64,158,222,41,22,50,41,109,421
177,Jerian Grant\grantje02,PG,25,CHI,53,23,1211,148,353,.419,44,132,.333,104,221,.471,.482,99,131,.756,22,109,131,253,40,5,68,97,439
178,Josh Gray\grayjo01,PG,24,PHO,3,0,57,9,26,.346,3,9,.333,6,17,.353,.404,3,5,.600,2,5,7,10,5,1,3,8,24
179,Danny Green\greenda02,SG,30,SAS,45,45,1176,148,367,.403,77,207,.372,71,160,.444,.508,23,31,.742,22,140,162,81,46,51,51,66,396
180,Draymond Green\greendr01,PF,27,GSW,48,48,1562,190,428,.444,53,176,.301,137,252,.544,.506,102,133,.767,60,319,379,348,60,68,138,122,535
181,Gerald Green\greenge01,SG,32,HOU,17,0,425,77,182,.423,51,128,.398,26,54,.481,.563,30,37,.811,6,47,53,9,10,8,13,41,235
182,JaMychal Green\greenja01,PF,27,MEM,34,33,903,132,287,.460,27,79,.342,105,208,.505,.507,48,66,.727,86,167,253,41,21,10,47,88,339
183,Jeff Green\greenje02,PF,31,CLE,53,0,1178,194,398,.487,29,93,.312,165,305,.541,.524,140,163,.859,47,133,180,68,28,19,51,101,557
184,Blake Griffin\griffbl01,PF,28,TOT,37,37,1274,285,649,.439,70,208,.337,215,441,.488,.493,192,243,.790,53,240,293,204,33,11,106,89,832
184,Blake Griffin\griffbl01,PF,28,LAC,33,33,1139,255,578,.441,64,187,.342,191,391,.488,.497,172,219,.785,46,216,262,179,30,9,99,78,746
184,Blake Griffin\griffbl01,PF,28,DET,4,4,135,30,71,.423,6,21,.286,24,50,.480,.465,20,24,.833,7,24,31,25,3,2,7,11,86
185,Daniel Hamilton\hamilda02,SG,22,OKC,3,0,24,5,10,.500,2,4,.500,3,6,.500,.600,0,0,,0,4,4,7,1,0,2,0,12
186,Tim Hardaway\hardati02,SG,25,NYK,34,31,1102,197,484,.407,74,235,.315,123,249,.494,.483,88,113,.779,22,121,143,97,38,8,53,68,556
187,James Harden\hardeja01,SG,28,HOU,46,46,1656,435,965,.451,186,488,.381,249,477,.522,.547,392,453,.865,24,203,227,412,84,33,197,115,1448
188,Maurice Harkless\harklma01,SF,24,POR,44,21,883,94,204,.461,27,76,.355,67,128,.523,.527,24,34,.706,30,88,118,29,28,32,32,73,239
189,Montrezl Harrell\harremo01,C,24,LAC,46,3,712,167,276,.605,0,2,.000,167,274,.609,.605,72,116,.621,63,123,186,35,20,31,38,76,406
190,Devin Harris\harride01,PG,34,DAL,44,1,807,118,284,.415,44,125,.352,74,159,.465,.493,93,112,.830,9,76,85,85,33,8,49,103,373
191,Gary Harris\harriga01,SG,23,DEN,50,50,1749,329,673,.489,120,302,.397,209,371,.563,.578,102,122,.836,29,109,138,160,93,13,94,84,880
192,Joe Harris\harrijo01,SG,26,BRK,54,8,1350,202,429,.471,102,254,.402,100,175,.571,.590,53,67,.791,35,144,179,82,24,11,55,100,559
193,Tobias Harris\harrito02,PF,25,TOT,50,50,1632,339,748,.453,117,287,.408,222,461,.482,.531,116,140,.829,36,217,253,98,37,16,53,95,911
193,Tobias Harris\harrito02,PF,25,DET,48,48,1563,320,709,.451,113,276,.409,207,433,.478,.531,115,136,.846,36,208,244,94,34,15,51,91,868
193,Tobias Harris\harrito02,PF,25,LAC,2,2,69,19,39,.487,4,11,.364,15,28,.536,.538,1,4,.250,0,9,9,4,3,1,2,4,43
194,Andrew Harrison\harrian01,PG,23,MEM,46,36,1037,131,316,.415,35,105,.333,96,211,.455,.470,94,116,.810,19,85,104,129,32,22,67,109,391
195,Josh Hart\hartjo01,SG,22,LAL,49,14,998,106,229,.463,48,124,.387,58,105,.552,.568,36,55,.655,26,150,176,55,34,11,29,76,296
196,Udonis Haslem\hasleud01,C,37,MIA,8,0,45,2,5,.400,1,3,.333,1,2,.500,.500,0,0,,2,3,5,3,0,1,2,2,5
197,Nigel Hayes\hayesni01,SF,23,LAL,2,0,11,1,3,.333,0,2,.000,1,1,1.000,.333,1,1,1.000,0,0,0,2,0,0,0,0,3
198,Gordon Hayward\haywago01,SF,27,BOS,1,1,5,1,2,.500,0,1,.000,1,1,1.000,.500,0,0,,0,1,1,0,0,0,0,1,2
199,Reggie Hearn\hearnre01,SG,26,DET,1,0,3,1,1,1.000,1,1,1.000,0,0,,1.500,0,0,,0,0,0,0,0,0,0,0,3
200,Myke Henry\henrymy01,SF,25,MEM,7,0,135,12,33,.364,9,22,.409,3,11,.273,.500,3,6,.500,2,11,13,6,8,4,6,8,36
201,John Henson\hensojo01,C,27,MIL,51,44,1297,195,331,.589,0,4,.000,195,327,.596,.589,70,118,.593,104,246,350,72,26,73,63,144,460
202,Juan Hernangomez\hernaju01,PF,22,DEN,19,3,215,19,51,.373,11,35,.314,8,16,.500,.480,9,11,.818,14,29,43,8,4,3,7,18,58
203,Willy Hernangomez\hernawi01,C,23,NYK,26,0,233,49,81,.605,1,5,.200,48,76,.632,.611,12,28,.429,22,45,67,21,8,7,26,32,111
204,Mario Hezonja\hezonma01,SF,22,ORL,47,13,882,143,310,.461,50,142,.352,93,168,.554,.542,34,43,.791,26,129,155,52,34,13,48,81,370
205,Isaiah Hicks\hicksis01,PF,23,NYK,1,0,17,2,5,.400,0,1,.000,2,4,.500,.400,1,2,.500,0,0,0,0,0,0,0,2,5
206,Buddy Hield\hieldbu01,SG,24,SAC,51,11,1220,243,552,.440,104,241,.432,139,311,.447,.534,44,50,.880,27,151,178,80,47,12,68,89,634
207,Nene Hilario\hilarne01,C,35,HOU,37,3,550,105,176,.597,0,2,.000,105,174,.603,.597,47,72,.653,34,89,123,37,20,9,29,90,257
208,George Hill\hillge01,PG,31,SAC,43,36,1143,153,326,.469,58,128,.453,95,198,.480,.558,77,99,.778,22,95,117,119,39,12,60,75,441
209,Darrun Hilliard\hillida01,SG,24,SAS,12,0,77,4,16,.250,0,5,.000,4,11,.364,.250,3,4,.750,0,6,6,6,2,0,3,6,11
210,Jrue Holiday\holidjr01,SG,27,NOP,53,53,1954,390,795,.491,84,259,.324,306,536,.571,.543,121,150,.807,33,199,232,285,76,36,133,121,985
211,Justin Holiday\holidju01,SG,28,CHI,52,52,1776,228,606,.376,129,342,.377,99,264,.375,.483,110,133,.827,28,204,232,119,55,29,69,104,695
212,John Holland\hollajo02,SF,29,CLE,4,0,17,1,4,.250,1,2,.500,0,2,.000,.375,0,0,,0,2,2,0,0,0,1,0,3
213,Rondae Hollis-Jefferson\holliro01,SF,23,BRK,46,45,1301,239,506,.472,12,43,.279,227,463,.490,.484,170,214,.794,67,232,299,107,39,31,78,96,660
214,Richaun Holmes\holmeri01,C,24,PHI,26,2,396,72,135,.533,3,22,.136,69,113,.611,.544,18,26,.692,32,83,115,28,11,11,15,60,165
215,Rodney Hood\hoodro01,SG,25,UTA,39,12,1084,234,552,.424,102,262,.389,132,290,.455,.516,85,97,.876,14,97,111,65,30,7,63,64,655
216,Al Horford\horfoal01,C,31,BOS,51,51,1651,273,537,.508,73,169,.432,200,368,.543,.576,59,81,.728,73,325,398,264,32,58,100,99,678
217,Danuel House\houseda01,SG,24,PHO,16,0,193,25,67,.373,8,31,.258,17,36,.472,.433,16,19,.842,9,28,37,8,5,1,5,15,74
218,Dwight Howard\howardw01,C,32,CHO,54,54,1685,317,585,.542,0,4,.000,317,581,.546,.542,220,398,.553,182,501,683,76,38,91,156,172,854
219,Josh Huestis\huestjo01,PF,26,OKC,50,3,724,44,132,.333,22,83,.265,22,49,.449,.417,3,13,.231,33,89,122,14,14,35,22,66,113
220,R.J. Hunter\hunterj01,SG,24,HOU,2,0,2,0,0,,0,0,,0,0,,,0,0,,0,1,1,2,0,0,0,0,0
221,Vince Hunter\huntevi01,PF,23,MEM,4,0,7,3,5,.600,0,0,,3,5,.600,.600,0,0,,2,1,3,0,0,1,1,0,6
222,Serge Ibaka\ibakase01,PF,28,TOR,49,49,1366,249,513,.485,68,191,.356,181,322,.562,.552,59,76,.776,45,251,296,39,16,66,57,141,625
223,Andre Iguodala\iguodan01,SF,34,GSW,46,4,1172,96,221,.434,19,79,.241,77,142,.542,.477,42,66,.636,38,132,170,151,40,26,47,67,253
224,Ersan Ilyasova\ilyaser01,PF,30,ATL,43,37,1093,171,371,.461,56,156,.359,115,215,.535,.536,57,73,.781,71,163,234,49,39,17,43,87,455
225,Joe Ingles\inglejo01,SF,30,UTA,54,53,1643,198,429,.462,130,290,.448,68,139,.489,.613,23,29,.793,17,200,217,219,57,9,97,111,549
226,Brandon Ingram\ingrabr01,SF,20,LAL,50,50,1693,296,646,.458,31,84,.369,265,562,.472,.482,173,254,.681,48,219,267,185,38,35,124,138,796
227,Kyrie Irving\irvinky01,PG,25,BOS,50,50,1642,451,929,.485,133,334,.398,318,595,.534,.557,203,229,.886,28,155,183,249,56,16,116,104,1238
228,Jonathan Isaac\isaacjo01,PF,20,ORL,15,2,285,30,74,.405,5,18,.278,25,56,.446,.439,14,18,.778,12,44,56,11,10,15,15,26,79
229,Wesley Iwundu\iwundwe01,SF,23,ORL,36,3,502,52,114,.456,6,23,.261,46,91,.505,.482,16,23,.696,19,55,74,36,17,5,14,37,126
230,Jarrett Jack\jackja01,PG,34,NYK,54,53,1422,172,404,.426,22,77,.286,150,327,.459,.453,50,62,.806,19,155,174,327,34,4,107,94,416
231,Demetrius Jackson\jacksde01,PG,23,HOU,12,0,63,4,14,.286,0,6,.000,4,8,.500,.286,0,0,,4,7,11,5,4,1,10,6,8
232,Josh Jackson\jacksjo02,SF,20,PHO,54,21,1234,223,556,.401,41,154,.266,182,402,.453,.438,102,165,.618,60,156,216,61,46,21,95,149,589
233,Justin Jackson\jacksju01,SF,22,SAC,39,12,722,89,211,.422,28,92,.304,61,119,.513,.488,14,21,.667,13,73,86,28,15,6,22,39,220
234,Reggie Jackson\jacksre01,PG,27,DET,33,33,894,181,406,.446,42,124,.339,139,282,.493,.498,79,94,.840,22,71,93,180,21,3,82,69,483
235,LeBron James\jamesle01,PF,33,CLE,53,53,1964,538,983,.547,93,256,.363,445,727,.612,.595,234,315,.743,61,365,426,463,85,55,236,87,1403
236,Mike James\jamesmi02,PG,27,TOT,36,10,687,123,321,.383,26,98,.265,97,223,.435,.424,64,84,.762,13,77,90,126,28,7,49,48,336
236,Mike James\jamesmi02,PG,27,PHO,32,10,669,121,312,.388,26,97,.268,95,215,.442,.429,64,84,.762,12,77,89,120,27,7,48,45,332
236,Mike James\jamesmi02,PG,27,NOP,4,0,18,2,9,.222,0,1,.000,2,8,.250,.222,0,0,,1,0,1,6,1,0,1,3,4
237,Al Jefferson\jeffeal01,C,33,IND,26,0,359,79,149,.530,0,1,.000,79,148,.534,.530,17,22,.773,19,82,101,22,12,11,17,50,175
238,Richard Jefferson\jefferi01,SF,37,DEN,16,0,138,10,24,.417,2,7,.286,8,17,.471,.458,4,7,.571,2,13,15,9,2,1,5,9,26
239,Jonas Jerebko\jerebjo01,PF,30,UTA,46,17,742,102,216,.472,39,91,.429,63,125,.504,.563,28,35,.800,38,109,147,33,20,7,19,92,271
240,Amir Johnson\johnsam01,C,30,PHI,48,9,735,94,173,.543,5,18,.278,89,155,.574,.558,35,58,.603,84,130,214,65,30,32,35,128,228
241,Brice Johnson\johnsbr02,PF,23,LAC,9,0,38,7,11,.636,0,1,.000,7,10,.700,.636,2,2,1.000,2,11,13,1,6,2,4,7,16
242,Dakari Johnson\johnsda04,C,22,OKC,24,5,142,20,37,.541,0,0,,20,37,.541,.541,8,14,.571,13,15,28,8,6,7,3,24,48
243,James Johnson\johnsja01,PF,30,MIA,47,22,1261,185,393,.471,38,129,.295,147,264,.557,.519,68,98,.694,39,189,228,186,42,28,102,130,476
244,Joe Johnson\johnsjo02,SF,36,UTA,32,3,700,95,226,.420,23,84,.274,72,142,.507,.471,20,24,.833,12,95,107,45,12,6,31,32,233
245,Stanley Johnson\johnsst04,SF,21,DET,42,29,1180,125,336,.372,41,149,.275,84,187,.449,.433,66,84,.786,21,138,159,69,52,9,42,102,357
246,Tyler Johnson\johnsty01,PG,25,MIA,47,16,1377,192,463,.415,77,221,.348,115,242,.475,.498,76,92,.826,25,143,168,105,40,25,59,107,537
247,Wesley Johnson\johnswe01,SF,30,LAC,47,28,1152,121,293,.413,47,141,.333,74,152,.487,.493,37,51,.725,20,155,175,47,58,53,47,110,326
248,Nikola Jokic\jokicni01,C,22,DEN,47,45,1490,284,599,.474,59,171,.345,225,428,.526,.523,149,176,.847,127,369,496,260,55,34,128,126,776
249,Damian Jones\jonesda03,C,22,GSW,3,0,8,0,0,,0,0,,0,0,,,0,0,,1,0,1,0,0,1,1,4,0
250,Derrick Jones\jonesde02,SF,20,TOT,16,8,226,17,44,.386,2,15,.133,15,29,.517,.409,13,20,.650,17,14,31,8,4,13,6,22,49
250,Derrick Jones\jonesde02,SF,20,PHO,6,0,33,2,4,.500,0,2,.000,2,2,1.000,.500,5,6,.833,2,2,4,3,1,4,1,2,9
250,Derrick Jones\jonesde02,SF,20,MIA,10,8,193,15,40,.375,2,13,.154,13,27,.481,.400,8,14,.571,15,12,27,5,3,9,5,20,40
251,Jalen Jones\jonesja04,SF,24,TOT,7,0,29,2,6,.333,1,2,.500,1,4,.250,.417,3,4,.750,0,4,4,0,1,0,0,2,8
251,Jalen Jones\jonesja04,SF,24,NOP,4,0,19,1,4,.250,1,1,1.000,0,3,.000,.375,2,2,1.000,0,3,3,0,0,0,0,2,5
251,Jalen Jones\jonesja04,SF,24,DAL,3,0,10,1,2,.500,0,1,.000,1,1,1.000,.500,1,2,.500,0,1,1,0,1,0,0,0,3
252,Tyus Jones\jonesty01,PG,21,MIN,57,10,1039,104,226,.460,29,82,.354,75,144,.521,.524,45,51,.882,12,84,96,157,67,3,37,75,282
253,DeAndre Jordan\jordade01,C,29,LAC,47,47,1508,222,340,.653,0,0,,222,340,.653,.653,97,165,.588,199,500,699,58,21,46,81,134,541
254,Cory Joseph\josepco01,PG,26,IND,55,2,1427,167,384,.435,47,130,.362,120,254,.472,.496,47,60,.783,19,136,155,169,49,12,52,84,428
255,Frank Kaminsky\kaminfr01,PF,24,CHO,51,4,1193,196,473,.414,62,183,.339,134,290,.462,.480,87,114,.763,31,162,193,79,26,14,44,64,541
256,Enes Kanter\kanteen01,C,25,NYK,52,52,1342,315,521,.605,0,2,.000,315,519,.607,.605,103,118,.873,186,363,549,78,25,28,101,134,733
257,Luke Kennard\kennalu01,SG,21,DET,46,4,857,119,270,.441,47,113,.416,72,157,.459,.528,33,39,.846,13,85,98,62,29,8,42,45,318
258,Michael Kidd-Gilchrist\kiddgmi01,SF,24,CHO,47,47,1246,197,387,.509,0,2,.000,197,385,.512,.509,73,106,.689,58,157,215,53,36,25,30,93,467
259,Sean Kilpatrick\kilpase01,SG,28,TOT,32,0,310,49,142,.345,21,74,.284,28,68,.412,.419,29,30,.967,1,49,50,23,3,2,22,21,148
259,Sean Kilpatrick\kilpase01,SG,28,BRK,16,0,183,25,86,.291,11,42,.262,14,44,.318,.355,18,19,.947,1,34,35,15,2,1,16,8,79
259,Sean Kilpatrick\kilpase01,SG,28,MIL,16,0,127,24,56,.429,10,32,.313,14,24,.583,.518,11,11,1.000,0,15,15,8,1,1,6,13,69
260,Maxi Kleber\klebima01,PF,26,DAL,49,35,869,105,221,.475,25,84,.298,80,137,.584,.532,25,35,.714,55,101,156,36,20,34,18,80,260
261,Furkan Korkmaz\korkmfu01,SG,20,PHI,6,0,32,3,12,.250,1,8,.125,2,4,.500,.292,2,2,1.000,2,4,6,2,1,0,1,4,9
262,Luke Kornet\kornelu01,PF,22,NYK,1,0,22,4,9,.444,3,7,.429,1,2,.500,.611,0,0,,1,9,10,0,0,4,0,0,11
263,Kyle Korver\korveky01,SG,36,CLE,53,0,1134,162,357,.454,119,279,.427,43,78,.551,.620,42,48,.875,9,95,104,67,18,17,38,86,485
264,Kosta Koufos\koufoko01,C,28,SAC,50,7,936,135,243,.556,0,0,,135,243,.556,.556,28,60,.467,98,210,308,55,34,20,36,91,298
265,Kyle Kuzma\kuzmaky01,PF,22,LAL,53,21,1577,317,701,.452,100,277,.361,217,424,.512,.524,100,141,.709,65,241,306,95,30,23,91,109,834
266,Mindaugas Kuzminskas\kuzmimi01,SF,28,NYK,1,0,2,0,2,.000,0,0,,0,2,.000,.000,0,0,,0,0,0,0,0,0,0,0,0
267,Skal Labissiere\labissk01,PF,21,SAC,42,17,754,132,285,.463,8,23,.348,124,262,.473,.477,58,77,.753,63,124,187,36,19,28,43,87,330
268,Jeremy Lamb\lambje01,SG,25,CHO,53,14,1330,260,587,.443,59,174,.339,201,413,.487,.493,136,160,.850,37,200,237,118,41,21,58,95,715
269,Shane Larkin\larkish01,PG,25,BOS,37,0,428,47,123,.382,17,49,.347,30,74,.405,.451,19,22,.864,6,38,44,43,13,2,17,38,130
270,Joffrey Lauvergne\lauvejo01,C,26,SAS,35,1,355,55,113,.487,0,5,.000,55,108,.509,.487,20,32,.625,39,66,105,28,7,1,25,33,130
271,Zach LaVine\lavinza01,SG,22,CHI,11,11,263,59,149,.396,22,56,.393,37,93,.398,.470,32,40,.800,4,45,49,29,11,1,16,26,172
272,Jake Layman\laymaja01,SF,23,POR,24,1,140,12,42,.286,4,18,.222,8,24,.333,.333,2,3,.667,4,10,14,9,5,3,4,13,30
273,T.J. Leaf\leaftj01,PF,20,IND,42,0,398,54,115,.470,17,36,.472,37,79,.468,.543,6,10,.600,25,42,67,8,5,3,9,42,131
274,Courtney Lee\leeco01,SG,32,NYK,56,56,1839,275,613,.449,89,218,.408,186,395,.471,.521,95,102,.931,27,164,191,153,67,12,71,86,734
275,Alex Len\lenal01,C,24,PHO,46,2,933,139,247,.563,0,0,,139,247,.563,.563,110,150,.733,122,239,361,57,16,38,58,103,388
276,Kawhi Leonard\leonaka01,SF,26,SAS,9,9,210,52,111,.468,11,35,.314,41,76,.539,.518,31,38,.816,6,36,42,21,18,9,16,9,146
277,Meyers Leonard\leoname01,C,25,POR,20,2,166,34,56,.607,9,17,.529,25,39,.641,.688,8,10,.800,8,34,42,9,4,0,6,23,85
278,Jon Leuer\leuerjo01,PF,28,DET,8,0,136,15,36,.417,0,3,.000,15,33,.455,.417,13,15,.867,7,25,32,5,1,3,7,16,43
279,Caris LeVert\leverca01,SF,23,BRK,50,9,1306,215,502,.428,57,170,.335,158,332,.476,.485,95,137,.693,39,152,191,203,57,16,119,109,582
280,DeAndre Liggins\liggide01,SG,29,TOT,36,1,545,31,76,.408,14,40,.350,17,36,.472,.500,2,5,.400,7,47,54,30,33,12,14,70,78
280,DeAndre Liggins\liggide01,SG,29,MIL,31,1,480,22,65,.338,11,36,.306,11,29,.379,.423,2,5,.400,5,44,49,27,27,10,13,61,57
280,DeAndre Liggins\liggide01,SG,29,NOP,5,0,65,9,11,.818,3,4,.750,6,7,.857,.955,0,0,,2,3,5,3,6,2,1,9,21
281,Damian Lillard\lillada01,PG,27,POR,48,48,1755,389,889,.438,141,387,.364,248,502,.494,.517,280,306,.915,34,189,223,320,47,21,148,82,1199
282,Jeremy Lin\linje01,PG,29,BRK,1,1,25,5,12,.417,1,2,.500,4,10,.400,.458,7,7,1.000,0,0,0,4,0,0,3,3,18
283,Shaun Livingston\livinsh01,PG,32,GSW,47,7,730,110,219,.502,0,3,.000,110,216,.509,.502,30,38,.789,23,58,81,89,20,15,38,78,250
284,Kevon Looney\looneke01,C,21,GSW,44,0,492,58,98,.592,0,0,,58,98,.592,.592,24,49,.490,52,76,128,24,10,26,21,62,140
285,Brook Lopez\lopezbr01,C,29,LAL,46,44,977,208,475,.438,67,202,.332,141,273,.516,.508,64,91,.703,50,131,181,70,19,62,72,125,547
286,Robin Lopez\lopezro01,C,29,CHI,53,53,1473,296,567,.522,2,7,.286,294,560,.525,.524,62,79,.785,120,132,252,108,13,44,90,98,656
287,Kevin Love\loveke01,C,29,CLE,48,48,1342,278,601,.463,105,260,.404,173,341,.507,.550,196,222,.883,92,357,449,78,33,20,72,101,857
288,Kyle Lowry\lowryky01,PG,31,TOR,51,51,1647,266,641,.415,148,387,.382,118,254,.465,.530,160,187,.856,46,250,296,324,64,8,130,116,840
289,Timothe Luwawu-Cabarrot\luwawti01,SF,22,PHI,44,7,755,95,249,.382,50,147,.340,45,102,.441,.482,44,56,.786,14,55,69,51,12,5,36,93,284
290,Tyler Lydon\lydonty01,PF,21,DEN,1,0,2,0,0,,0,0,,0,0,,,0,0,,0,0,0,0,0,0,0,0,0
291,Trey Lyles\lylestr01,PF,22,DEN,49,2,1021,196,391,.501,67,162,.414,129,229,.563,.587,74,110,.673,43,218,261,59,22,23,43,80,533
292,Shelvin Mack\macksh01,PG,27,ORL,41,3,725,76,177,.429,14,50,.280,62,127,.488,.469,44,58,.759,14,78,92,149,24,5,34,43,210
293,Josh Magette\magetjo01,PG,28,ATL,9,0,69,6,14,.429,3,6,.500,3,8,.375,.536,6,6,1.000,1,5,6,18,2,0,2,6,21
294,Ian Mahinmi\mahinia01,C,31,WAS,53,0,782,83,144,.576,0,1,.000,83,143,.580,.576,64,86,.744,86,115,201,37,26,28,63,163,230
295,Thon Maker\makerth01,C,20,MIL,53,9,952,90,226,.398,23,73,.315,67,153,.438,.449,46,68,.676,59,125,184,32,30,46,34,124,249
296,Boban Marjanovic\marjabo01,C,29,TOT,20,1,171,41,79,.519,0,0,,41,79,.519,.519,36,45,.800,15,42,57,14,4,6,22,28,118
296,Boban Marjanovic\marjabo01,C,29,DET,19,1,171,41,79,.519,0,0,,41,79,.519,.519,36,45,.800,15,42,57,14,4,6,22,28,118
296,Boban Marjanovic\marjabo01,C,29,LAC,1,0,0,0,0,,0,0,,0,0,,,0,0,,0,0,0,0,0,0,0,0,0
297,Lauri Markkanen\markkla01,PF,20,CHI,47,47,1418,259,603,.430,109,299,.365,150,304,.493,.520,94,110,.855,50,313,363,63,25,28,58,77,721
298,Jarell Martin\martija01,PF,23,MEM,51,19,1011,126,282,.447,17,52,.327,109,230,.474,.477,47,58,.810,66,120,186,31,29,36,50,143,316
299,Frank Mason\masonfr01,PG,23,SAC,29,2,539,77,200,.385,18,43,.419,59,157,.376,.430,48,63,.762,13,49,62,84,15,4,38,32,220
300,Mangok Mathiang\mathima01,C,25,CHO,3,0,10,0,2,.000,0,0,,0,2,.000,.000,0,0,,1,5,6,0,0,0,0,2,0
301,Wesley Matthews\matthwe02,SF,31,DAL,55,54,1887,252,616,.409,132,348,.379,120,268,.448,.516,76,93,.817,21,154,175,156,67,13,74,124,712
302,Luc Mbah a Moute\mbahalu01,PF,31,HOU,36,10,977,94,209,.450,40,112,.357,54,97,.557,.545,36,52,.692,16,104,120,36,46,16,45,62,264
303,James Michael McAdoo\mcadoja01,PF,25,PHI,3,0,18,2,7,.286,2,7,.286,0,0,,.429,2,2,1.000,0,2,2,0,0,1,1,1,8
304,Patrick McCaw\mccawpa01,SG,22,GSW,49,6,776,73,168,.435,15,61,.246,58,107,.542,.479,18,25,.720,16,55,71,68,37,9,31,54,179
305,C.J. McCollum\mccolcj01,SG,26,POR,54,54,1947,448,989,.453,135,318,.425,313,671,.466,.521,146,169,.864,35,177,212,172,54,19,100,118,1177
306,T.J. McConnell\mccontj01,PG,25,PHI,45,1,1092,143,276,.518,20,42,.476,123,234,.526,.554,23,28,.821,25,126,151,199,56,10,84,83,329
307,Erik McCree\mccreer01,SF,24,UTA,1,0,2,0,1,.000,0,0,,0,1,.000,.000,0,0,,0,0,0,0,0,0,0,0,0
308,Chris McCullough\mcculch01,PF,22,WAS,17,0,84,18,40,.450,1,7,.143,17,33,.515,.463,7,12,.583,7,17,24,3,0,5,2,8,44
309,Doug McDermott\mcderdo01,SF,26,NYK,55,1,1172,151,328,.460,53,137,.387,98,191,.513,.541,40,53,.755,33,101,134,50,10,12,34,73,395
310,JaVale McGee\mcgeeja01,C,30,GSW,39,4,311,66,106,.623,0,6,.000,66,100,.660,.623,23,29,.793,28,45,73,17,10,31,15,49,155
311,Alfonzo McKinnie\mckinal01,SF,25,TOR,11,0,43,6,12,.500,2,7,.286,4,5,.800,.583,2,3,.667,0,6,6,1,1,1,3,6,16
312,Ben McLemore\mclembe01,SG,24,MEM,32,6,526,75,185,.405,23,79,.291,52,106,.491,.468,25,29,.862,13,44,57,27,20,6,31,76,198
313,Josh McRoberts\mcrobjo01,PF,30,DAL,2,0,6,0,1,.000,0,1,.000,0,0,,.000,0,0,,0,0,0,0,0,0,0,2,0
314,Jodie Meeks\meeksjo01,SG,30,WAS,52,0,771,99,268,.369,45,147,.306,54,121,.446,.453,70,80,.875,12,70,82,46,21,3,27,39,313
315,Salah Mejri\mejrisa01,C,31,DAL,50,1,621,78,120,.650,0,3,.000,78,117,.667,.650,30,54,.556,75,140,215,28,20,57,32,105,186
316,Jordan Mickey\mickejo01,PF,23,MIA,17,2,236,32,67,.478,1,11,.091,31,56,.554,.485,11,16,.688,14,58,72,9,3,8,15,32,76
317,Khris Middleton\middlkh01,SF,26,MIL,53,53,1955,391,843,.464,98,282,.348,293,561,.522,.522,185,214,.864,27,252,279,222,68,10,121,168,1065
318,C.J. Miles\milescj01,SF,30,TOR,44,3,814,145,367,.395,106,275,.385,39,92,.424,.540,45,54,.833,10,77,87,29,28,16,22,80,441
319,Darius Miller\milleda01,SF,27,NOP,53,2,1203,140,308,.455,99,234,.423,41,74,.554,.615,41,47,.872,8,92,100,65,17,10,33,107,420
320,Malcolm Miller\millema01,SF,24,TOR,3,0,13,2,5,.400,2,4,.500,0,1,.000,.600,0,0,,1,1,2,0,0,0,0,1,6
321,Patty Mills\millspa02,PG,29,SAS,56,12,1340,185,434,.426,105,266,.395,80,168,.476,.547,66,75,.880,14,90,104,148,40,8,77,75,541
322,Paul Millsap\millspa01,PF,32,DEN,16,16,475,90,202,.446,20,58,.345,70,144,.486,.495,45,65,.692,24,75,99,48,17,20,33,39,245
323,Nikola Mirotic\mirotni01,PF,26,TOT,27,4,690,151,323,.467,72,173,.416,79,150,.527,.579,69,86,.802,24,150,174,43,20,14,35,49,443
323,Nikola Mirotic\mirotni01,PF,26,CHI,25,3,622,143,302,.474,69,161,.429,74,141,.525,.588,65,79,.823,18,141,159,39,15,13,31,45,420
323,Nikola Mirotic\mirotni01,PF,26,NOP,2,1,68,8,21,.381,3,12,.250,5,9,.556,.452,4,7,.571,6,9,15,4,5,1,4,4,23
324,Donovan Mitchell\mitchdo01,SG,21,UTA,51,43,1615,363,814,.446,116,327,.355,247,487,.507,.517,133,159,.836,26,143,169,174,76,21,133,147,975
325,Naz Mitrou-Long\mitrona01,SG,24,UTA,1,0,1,1,1,1.000,1,1,1.000,0,0,,1.500,0,0,,0,0,0,0,0,0,0,0,3
326,Malik Monk\monkma01,SG,19,CHO,38,0,474,69,207,.333,40,118,.339,29,89,.326,.430,12,17,.706,2,32,34,47,10,3,21,32,190
327,Greg Monroe\monrogr01,C,27,TOT,26,14,564,115,193,.596,0,0,,115,193,.596,.596,34,53,.642,58,133,191,57,18,6,47,49,264
327,Greg Monroe\monrogr01,C,27,MIL,5,0,79,16,33,.485,0,0,,16,33,.485,.485,2,4,.500,6,19,25,5,0,0,6,7,34
327,Greg Monroe\monrogr01,C,27,PHO,20,14,465,97,155,.626,0,0,,97,155,.626,.626,31,46,.674,50,110,160,50,16,6,40,40,225
327,Greg Monroe\monrogr01,C,27,BOS,1,0,20,2,5,.400,0,0,,2,5,.400,.400,1,3,.333,2,4,6,2,2,0,1,2,5
328,Luis Montero\montelu01,SG,24,DET,2,0,8,0,1,.000,0,0,,0,1,.000,.000,0,0,,0,2,2,0,0,0,2,0,0
329,Ben Moore\moorebe01,PF,22,IND,2,0,9,0,0,,0,0,,0,0,,,0,0,,0,1,1,1,0,0,0,4,0
330,E'Twaun Moore\mooreet01,SG,28,NOP,53,51,1696,280,537,.521,89,203,.438,191,334,.572,.604,34,49,.694,36,110,146,113,51,7,67,120,683
331,Eric Moreland\moreler01,PF,26,DET,43,1,494,29,57,.509,0,0,,29,57,.509,.509,7,16,.438,46,107,153,46,16,28,21,76,65
332,Marcus Morris\morrima03,PF,28,BOS,32,13,785,138,331,.417,45,125,.360,93,206,.451,.485,69,86,.802,26,143,169,42,18,9,41,60,390
333,Markieff Morris\morrima02,PF,28,WAS,47,47,1228,197,418,.471,47,125,.376,150,293,.512,.528,68,81,.840,53,211,264,70,37,23,76,148,509
334,Monte Morris\morrimo01,PG,22,DEN,1,0,3,0,1,.000,0,1,.000,0,0,,.000,0,0,,0,0,0,1,0,0,0,0,0
335,Johnathan Motley\motlejo01,PF,22,DAL,2,0,4,3,3,1.000,0,0,,3,3,1.000,1.000,3,6,.500,0,4,4,0,0,1,0,0,9
336,Timofey Mozgov\mozgoti01,C,31,BRK,26,14,328,45,82,.549,4,18,.222,41,64,.641,.573,19,25,.760,28,58,86,8,5,11,30,36,113
337,Emmanuel Mudiay\mudiaem01,PG,21,DEN,42,0,752,129,322,.401,38,102,.373,91,220,.414,.460,63,78,.808,16,78,94,121,21,4,72,47,359
338,Shabazz Muhammad\muhamsh01,SF,25,MIN,31,2,298,45,117,.385,4,19,.211,41,98,.418,.402,22,31,.710,15,30,45,7,5,2,4,23,116
339,Xavier Munford\munfoxa02,SG,25,MIL,3,0,11,1,4,.250,0,0,,1,4,.250,.250,1,2,.500,1,0,1,1,1,0,2,2,3
340,Dejounte Murray\murrade01,PG,21,SAS,56,23,1068,159,370,.430,4,18,.222,155,352,.440,.435,66,93,.710,74,221,295,154,49,18,92,101,388
341,Jamal Murray\murraja01,PG,20,DEN,53,52,1602,316,694,.455,105,275,.382,211,419,.504,.531,141,151,.934,54,136,190,158,45,16,109,109,878
342,Mike Muscala\muscami01,C,26,ATL,26,5,426,56,108,.519,21,45,.467,35,63,.556,.616,25,28,.893,24,72,96,22,13,11,15,40,158
343,Abdel Nader\naderab01,SF,24,BOS,26,0,253,25,73,.342,13,36,.361,12,37,.324,.432,5,10,.500,8,27,35,16,6,4,15,23,68
344,Larry Nance\nancela02,PF,25,LAL,42,17,922,152,253,.601,1,4,.250,151,249,.606,.603,55,87,.632,108,176,284,57,59,20,41,113,360
345,Shabazz Napier\napiesh01,PG,26,POR,48,8,1030,159,354,.449,51,129,.395,108,225,.480,.521,75,91,.824,16,92,108,110,57,10,64,57,444
346,Jameer Nelson\nelsoja01,PG,35,NOP,43,0,897,84,205,.410,40,110,.364,44,95,.463,.507,13,17,.765,11,85,96,156,23,3,56,67,221
347,Raul Neto\netora01,PG,25,UTA,29,0,373,56,117,.479,18,39,.462,38,78,.487,.556,22,28,.786,6,34,40,50,9,3,26,25,152
348,Georges Niang\niangge01,PF,24,UTA,1,0,1,0,0,,0,0,,0,0,,,0,0,,0,0,0,0,1,0,0,0,0
349,Joakim Noah\noahjo01,C,32,NYK,7,0,40,5,10,.500,0,0,,5,10,.500,.500,2,4,.500,6,8,14,4,2,2,4,5,12
350,Nerlens Noel\noelne01,C,23,DAL,18,6,225,28,53,.528,0,0,,28,53,.528,.528,16,19,.842,26,47,73,6,10,10,15,31,72
351,Lucas Nogueira\noguelu01,C,25,TOR,32,2,305,35,60,.583,3,14,.214,32,46,.696,.608,14,18,.778,14,50,64,13,17,32,11,41,87
352,Dirk Nowitzki\nowitdi01,C,39,DAL,55,55,1373,249,544,.458,94,223,.422,155,321,.483,.544,77,86,.895,20,293,313,85,35,26,35,93,669
353,Frank Ntilikina\ntilila01,PG,19,NYK,53,0,1063,108,307,.352,31,95,.326,77,212,.363,.402,29,43,.674,18,91,109,176,51,10,99,123,276
354,Jusuf Nurkic\nurkiju01,C,23,POR,52,52,1387,308,638,.483,0,7,.000,308,631,.488,.483,134,200,.670,111,319,430,90,44,68,133,156,750
355,David Nwaba\nwabada01,SG,25,CHI,41,3,895,103,199,.518,5,17,.294,98,182,.538,.530,72,119,.605,45,132,177,48,32,19,37,83,283
356,Johnny O'Bryant\obryajo01,PF,24,CHO,36,0,379,68,171,.398,14,43,.326,54,128,.422,.439,21,25,.840,29,65,94,14,8,6,15,45,171
357,Royce O'Neale\onealro01,SF,24,UTA,41,0,536,64,147,.435,25,66,.379,39,81,.481,.520,41,52,.788,8,107,115,48,19,2,25,48,194
358,Kyle O'Quinn\oquinky01,C,27,NYK,54,4,908,143,244,.586,0,7,.000,143,237,.603,.586,70,92,.761,78,227,305,104,24,56,72,139,356
359,Semi Ojeleye\ojelese01,PF,23,BOS,49,0,687,39,124,.315,29,96,.302,10,28,.357,.431,13,21,.619,24,73,97,12,15,2,14,57,120
360,Emeka Okafor\okafoem01,C,35,NOP,1,0,9,1,2,.500,0,0,,1,2,.500,.500,1,2,.500,2,0,2,0,0,0,0,0,3
361,Jahlil Okafor\okafoja01,C,22,TOT,22,0,293,57,111,.514,0,3,.000,57,108,.528,.514,20,27,.741,16,53,69,11,3,14,17,46,134
361,Jahlil Okafor\okafoja01,C,22,PHI,2,0,25,4,9,.444,0,0,,4,9,.444,.444,2,4,.500,4,5,9,1,0,2,3,7,10
361,Jahlil Okafor\okafoja01,C,22,BRK,20,0,268,53,102,.520,0,3,.000,53,99,.535,.520,18,23,.783,12,48,60,10,3,12,14,39,124
362,Victor Oladipo\oladivi01,SG,25,IND,49,49,1686,428,878,.487,117,300,.390,311,578,.538,.554,205,254,.807,25,231,256,199,95,40,140,115,1178
363,Kelly Olynyk\olynyke01,PF,26,MIA,54,21,1264,218,440,.495,68,185,.368,150,255,.588,.573,89,118,.754,59,240,299,123,41,23,107,154,593
364,Cedi Osman\osmande01,SF,22,CLE,42,0,330,39,77,.506,12,32,.375,27,45,.600,.584,11,16,.688,9,60,69,12,10,2,13,40,101
365,Kelly Oubre\oubreke01,SF,22,WAS,55,9,1507,220,512,.430,87,232,.375,133,280,.475,.515,125,149,.839,44,213,257,56,49,20,61,159,652
366,Zaza Pachulia\pachuza01,C,33,GSW,45,45,670,109,182,.599,0,0,,109,182,.599,.599,47,58,.810,54,169,223,74,28,9,52,84,265
367,Marcus Paige\paigema01,PG,24,CHO,1,0,3,0,2,.000,0,0,,0,2,.000,.000,0,0,,0,2,2,0,0,0,0,0,0
368,Georgios Papagiannis\papagge01,C,20,SAC,16,0,118,17,41,.415,0,0,,17,41,.415,.415,0,0,,12,24,36,9,2,6,8,12,34
369,Jabari Parker\parkeja01,PF,22,MIL,3,0,53,10,20,.500,1,4,.250,9,16,.563,.525,12,14,.857,1,6,7,2,2,2,2,4,33
370,Tony Parker\parketo01,PG,35,SAS,30,21,624,109,235,.464,5,21,.238,104,214,.486,.474,27,41,.659,4,59,63,120,18,1,41,28,250
371,Chandler Parsons\parsoch01,SF,29,MEM,26,7,545,87,179,.486,39,95,.411,48,84,.571,.595,15,25,.600,12,62,74,53,13,9,29,46,228
372,Patrick Patterson\pattepa01,PF,28,OKC,56,1,836,60,173,.347,40,115,.348,20,58,.345,.462,22,24,.917,20,98,118,35,34,14,23,58,182
373,Brandon Paul\paulbr01,SG,26,SAS,49,2,478,45,105,.429,14,48,.292,31,57,.544,.495,20,33,.606,5,56,61,35,24,5,23,49,124
374,Chris Paul\paulch01,PG,32,HOU,35,35,1124,232,497,.467,98,239,.410,134,258,.519,.565,120,132,.909,22,179,201,292,63,11,81,90,682
375,Adreian Payne\paynead01,PF,26,ORL,5,0,43,7,10,.700,2,3,.667,5,7,.714,.800,5,6,.833,2,7,9,0,2,0,2,6,21
376,Elfrid Payton\paytoel01,PG,23,ORL,44,44,1257,238,458,.520,25,67,.373,213,391,.545,.547,72,114,.632,47,127,174,275,64,16,114,97,573
377,Gary Payton\paytoga02,PG,25,TOT,15,6,128,16,42,.381,2,14,.143,14,28,.500,.405,2,3,.667,6,15,21,13,3,3,3,21,36
377,Gary Payton\paytoga02,PG,25,MIL,12,6,106,13,33,.394,2,12,.167,11,21,.524,.424,2,3,.667,4,13,17,9,3,1,3,17,30
377,Gary Payton\paytoga02,PG,25,LAL,3,0,22,3,9,.333,0,2,.000,3,7,.429,.333,0,0,,2,2,4,4,0,2,0,4,6
378,London Perrantes\perralo01,PG,23,CLE,1,0,3,0,1,.000,0,0,,0,1,.000,.000,0,0,,0,0,0,0,0,0,0,1,0
379,Alec Peters\peteral01,PF,22,PHO,9,0,81,5,24,.208,3,21,.143,2,3,.667,.271,3,3,1.000,4,14,18,7,0,2,1,2,16
380,Marshall Plumlee\plumlma02,C,25,MIL,6,0,44,1,3,.333,0,0,,1,3,.333,.333,12,16,.750,4,12,16,2,0,1,3,8,14
381,Mason Plumlee\plumlma01,C,27,DEN,50,26,1047,157,270,.581,0,1,.000,157,269,.584,.581,56,133,.421,94,206,300,99,36,58,79,118,370
382,Miles Plumlee\plumlmi01,C,29,ATL,36,33,611,71,116,.612,0,0,,71,116,.612,.612,18,39,.462,50,89,139,35,13,22,43,54,160
383,Jakob Poeltl\poeltja01,C,22,TOR,54,0,975,165,254,.650,1,2,.500,164,252,.651,.652,40,73,.548,115,140,255,27,19,64,51,147,371
384,Quincy Pondexter\pondequ01,SF,29,CHI,23,1,196,14,49,.286,3,22,.136,11,27,.407,.316,14,17,.824,8,19,27,9,8,2,11,24,45
385,Otto Porter\porteot01,SF,24,WAS,51,51,1621,284,580,.490,85,205,.415,199,375,.531,.563,75,89,.843,67,255,322,102,81,27,46,105,728
386,Bobby Portis\portibo01,PF,22,CHI,44,1,916,207,446,.464,39,120,.325,168,326,.515,.508,84,103,.816,97,192,289,75,26,11,55,60,537
387,Kristaps Porzingis\porzikr01,PF,22,NYK,48,48,1553,390,889,.439,90,229,.393,300,660,.455,.489,218,275,.793,62,254,316,57,36,115,93,141,1088
388,Dwight Powell\poweldw01,C,26,DAL,54,4,1048,155,258,.601,13,50,.260,142,208,.683,.626,71,102,.696,85,184,269,47,46,21,36,120,394
389,Norman Powell\powelno01,SG,24,TOR,46,12,759,111,276,.402,38,126,.302,73,150,.487,.471,29,36,.806,8,75,83,67,32,13,50,83,289
390,Alex Poythress\poythal01,PF,24,IND,21,0,90,9,21,.429,3,8,.375,6,13,.462,.500,0,0,,6,7,13,2,3,1,2,13,21
391,Jacob Pullen\pulleja01,PG,28,PHI,3,0,6,1,2,.500,0,1,.000,1,1,1.000,.500,0,0,,0,0,0,0,0,0,1,0,2
392,Zhou Qi\qizh01,C,22,HOU,14,0,75,4,24,.167,2,15,.133,2,9,.222,.208,7,10,.700,2,11,13,1,2,6,5,12,17
393,Ivan Rabb\rabbiv01,PF,20,MEM,15,1,159,33,49,.673,0,0,,33,49,.673,.673,9,11,.818,19,30,49,11,2,4,14,15,75
394,Julius Randle\randlju01,C,23,LAL,54,21,1296,299,541,.553,9,39,.231,290,502,.578,.561,160,232,.690,110,286,396,117,25,34,129,171,767
395,Zach Randolph\randoza01,PF,36,SAC,46,44,1174,281,587,.479,34,105,.324,247,482,.512,.508,70,89,.787,83,238,321,97,39,9,97,94,666
396,J.J. Redick\redicjj01,SG,33,PHI,40,40,1289,226,511,.442,106,261,.406,120,250,.480,.546,123,130,.946,6,99,105,131,22,3,58,84,681
397,Davon Reed\reedda01,SG,22,PHO,5,0,36,2,11,.182,1,4,.250,1,7,.143,.227,0,0,,0,2,2,3,1,0,2,3,5
398,Willie Reed\reedwi02,C,27,TOT,42,5,428,81,121,.669,1,2,.500,80,119,.672,.674,32,55,.582,35,87,122,10,9,22,19,56,195
398,Willie Reed\reedwi02,C,27,LAC,39,5,419,80,120,.667,1,2,.500,79,118,.669,.671,32,55,.582,35,86,121,9,9,22,19,53,193
398,Willie Reed\reedwi02,C,27,DET,3,0,9,1,1,1.000,0,0,,1,1,1.000,1.000,0,0,,0,1,1,1,0,0,0,3,2
399,Josh Richardson\richajo01,SF,24,MIA,55,55,1886,279,613,.455,96,250,.384,183,363,.504,.533,82,101,.812,41,144,185,159,73,52,104,140,736
400,Malachi Richardson\richama01,SG,22,SAC,25,4,319,29,88,.330,12,39,.308,17,49,.347,.398,17,22,.773,5,28,33,13,10,1,10,27,87
401,Austin Rivers\riverau01,SG,25,LAC,32,30,1047,183,438,.418,81,200,.405,102,238,.429,.510,59,91,.648,15,52,67,115,40,8,60,81,506
402,Andre Roberson\roberan03,SG,26,OKC,39,39,1037,87,162,.537,8,36,.222,79,126,.627,.562,12,38,.316,75,110,185,46,45,35,30,89,194
403,Rajon Rondo\rondora01,PG,31,NOP,39,38,951,120,265,.453,33,94,.351,87,171,.509,.515,6,11,.545,17,116,133,279,36,8,80,70,279
404,Derrick Rose\rosede01,PG,29,CLE,16,7,308,58,132,.439,6,24,.250,52,108,.481,.462,35,41,.854,10,19,29,26,3,4,28,14,157
405,Terrence Ross\rosste01,SG,26,ORL,22,20,576,72,177,.407,28,85,.329,44,92,.478,.486,26,35,.743,10,60,70,35,27,9,25,44,198
406,Terry Rozier\roziete01,PG,23,BOS,56,3,1340,199,499,.399,93,246,.378,106,253,.419,.492,61,78,.782,43,211,254,129,59,10,50,80,552
407,Ricky Rubio\rubiori01,PG,27,UTA,53,53,1562,227,554,.410,60,184,.326,167,370,.451,.464,143,166,.861,27,200,227,275,82,6,150,139,657
408,D'Angelo Russell\russeda01,PG,21,BRK,22,12,513,129,305,.423,26,94,.277,103,211,.488,.466,53,76,.697,13,66,79,96,16,5,74,45,337
409,Domantas Sabonis\sabondo01,C,21,IND,53,19,1350,261,485,.538,9,27,.333,252,458,.550,.547,129,177,.729,132,304,436,115,27,25,107,159,660
410,JaKarr Sampson\sampsja02,SF,24,SAC,10,2,140,19,32,.594,3,4,.750,16,28,.571,.641,2,2,1.000,10,28,38,4,2,6,3,24,43
411,Dario Saric\saricda01,PF,23,PHI,50,45,1535,256,577,.444,94,250,.376,162,327,.495,.525,109,122,.893,106,242,348,131,38,15,99,106,715
412,Tomas Satoransky\satorto01,SG,26,WAS,46,7,815,96,191,.503,23,52,.442,73,139,.525,.563,41,57,.719,35,73,108,134,29,6,35,64,256
413,Dennis Schroder\schrode01,PG,24,ATL,52,52,1629,388,901,.431,56,196,.286,332,705,.471,.462,176,201,.876,36,124,160,332,56,5,137,113,1008
414,Mike Scott\scottmi01,PF,29,WAS,50,1,926,189,338,.559,48,112,.429,141,226,.624,.630,32,47,.681,28,135,163,45,19,9,56,102,458
415,Thabo Sefolosha\sefolth01,SF,33,UTA,38,6,806,118,240,.492,32,84,.381,86,156,.551,.558,44,54,.815,29,132,161,33,52,12,30,59,312
416,Wayne Selden\seldewa01,SG,23,MEM,20,8,389,57,141,.404,24,63,.381,33,78,.423,.489,27,37,.730,9,26,35,36,11,1,35,39,165
417,Ramon Sessions\sessira01,PG,31,NYK,13,3,167,17,53,.321,2,11,.182,15,42,.357,.340,12,15,.800,1,17,18,27,7,1,15,14,48
418,Iman Shumpert\shumpim01,SG,27,CLE,14,6,276,22,58,.379,7,26,.269,15,32,.469,.440,11,15,.733,7,34,41,17,9,5,17,22,62
419,Pascal Siakam\siakapa01,PF,23,TOR,53,4,1057,148,308,.481,17,100,.170,131,208,.630,.508,31,53,.585,58,175,233,97,46,29,44,106,344
420,Ben Simmons\simmobe01,PG,21,PHI,50,50,1755,352,666,.529,0,10,.000,352,656,.537,.529,128,227,.564,89,299,388,362,89,44,185,141,832
421,Jonathon Simmons\simmojo02,SG,28,ORL,53,34,1533,280,592,.473,52,152,.342,228,440,.518,.517,134,174,.770,46,136,182,120,41,15,109,137,746
422,Kobi Simmons\simmoko01,PG,20,MEM,12,0,176,19,45,.422,3,13,.231,16,32,.500,.456,5,5,1.000,3,16,19,12,8,3,9,17,46
423,Kyle Singler\singlky01,SF,29,OKC,10,0,52,7,19,.368,2,5,.400,5,14,.357,.421,7,13,.538,1,8,9,1,1,0,3,4,23
424,Marcus Smart\smartma01,SG,23,BOS,46,10,1393,160,448,.357,63,211,.299,97,237,.409,.427,81,110,.736,36,128,164,214,58,22,113,122,464
425,Dennis Smith\smithde03,PG,20,DAL,47,47,1368,266,676,.393,72,225,.320,194,451,.430,.447,91,133,.684,35,147,182,226,46,12,135,103,695
426,Ish Smith\smithis01,PG,29,DET,53,18,1275,247,524,.471,10,40,.250,237,484,.490,.481,57,81,.704,20,127,147,233,38,13,64,87,561
427,J.R. Smith\smithjr01,SG,32,CLE,52,49,1548,151,392,.385,99,274,.361,52,118,.441,.511,24,36,.667,22,132,154,103,48,6,48,115,425
428,Jason Smith\smithja02,C,31,WAS,22,2,208,27,82,.329,1,22,.045,26,60,.433,.335,14,16,.875,16,23,39,10,3,10,11,37,69
429,Josh Smith\smithjo03,PF,32,NOP,3,0,12,1,4,.250,0,0,,1,4,.250,.250,0,0,,3,1,4,0,0,0,0,3,2
430,Tony Snell\snellto01,SG,26,MIL,48,36,1392,130,286,.455,73,176,.415,57,110,.518,.582,29,38,.763,8,95,103,58,30,17,22,75,362
431,Marreese Speights\speigma01,C,30,ORL,44,3,581,117,298,.393,73,200,.365,44,98,.449,.515,36,48,.750,17,97,114,32,6,20,34,93,343
432,Nik Stauskas\stausni01,SG,24,TOT,29,0,397,43,113,.381,31,76,.408,12,37,.324,.518,16,20,.800,3,44,47,27,7,3,21,17,133
432,Nik Stauskas\stausni01,SG,24,PHI,6,0,45,1,4,.250,0,1,.000,1,3,.333,.250,2,2,1.000,0,1,1,1,4,0,4,3,4
432,Nik Stauskas\stausni01,SG,24,BRK,23,0,352,42,109,.385,31,75,.413,11,34,.324,.528,14,18,.778,3,43,46,26,3,3,17,14,129
433,Lance Stephenson\stephla01,SG,27,IND,55,6,1282,201,463,.434,47,148,.318,154,315,.489,.485,59,90,.656,42,261,303,167,31,11,92,119,508
434,Julyan Stone\stoneju01,SG,29,CHO,9,0,38,2,4,.500,2,4,.500,0,0,,.750,0,0,,0,11,11,9,2,1,4,8,6
435,Caleb Swanigan\swanica01,PF,20,POR,16,3,137,16,44,.364,1,6,.167,15,38,.395,.375,8,13,.615,13,24,37,9,5,3,11,24,41
436,Jayson Tatum\tatumja01,SF,19,BOS,56,56,1733,267,557,.479,74,172,.430,193,385,.501,.546,155,189,.820,39,254,293,79,54,42,74,118,763
437,Isaiah Taylor\taylois01,PG,23,ATL,40,0,561,63,160,.394,9,33,.273,54,127,.425,.422,37,58,.638,11,39,50,87,18,8,30,49,172
438,Jeff Teague\teaguje01,PG,29,MIN,46,46,1528,215,501,.429,52,144,.361,163,357,.457,.481,106,131,.809,19,115,134,326,68,16,125,118,588
439,Mirza Teletovic\teletmi01,PF,32,MIL,10,0,159,25,57,.439,21,45,.467,4,12,.333,.623,0,0,,3,20,23,10,4,1,7,14,71
440,Garrett Temple\templga01,SG,31,SAC,49,33,1221,152,370,.411,64,173,.370,88,197,.447,.497,45,61,.738,16,98,114,96,45,23,63,100,413
441,Milos Teodosic\teodomi01,PG,30,LAC,25,25,640,83,217,.382,48,142,.338,35,75,.467,.493,18,21,.857,13,66,79,133,13,3,54,58,232
442,Jason Terry\terryja01,SG,40,MIL,22,0,235,15,41,.366,7,27,.259,8,14,.571,.451,2,2,1.000,1,17,18,15,12,4,11,19,39
443,Daniel Theis\theisda01,C,25,BOS,54,2,785,104,196,.531,16,51,.314,88,145,.607,.571,50,68,.735,73,159,232,46,24,40,52,133,274
444,Isaiah Thomas\thomais02,PG,28,CLE,15,14,406,70,194,.361,22,87,.253,48,107,.449,.418,59,68,.868,7,24,31,68,9,2,41,25,221
445,Lance Thomas\thomala01,PF,29,NYK,53,21,960,72,186,.387,30,78,.385,42,108,.389,.468,32,39,.821,34,93,127,29,18,12,31,93,206
446,Klay Thompson\thompkl01,SG,27,GSW,54,54,1850,424,864,.491,174,388,.448,250,476,.525,.591,61,71,.859,23,194,217,142,39,31,94,90,1083
447,Tristan Thompson\thomptr01,C,26,CLE,33,12,679,85,144,.590,0,0,,85,144,.590,.590,33,54,.611,70,127,197,21,11,11,21,68,203
448,Sindarius Thornwell\thornsi01,SG,23,LAC,48,8,637,56,126,.444,15,39,.385,41,87,.471,.504,31,46,.674,13,58,71,34,26,17,32,77,158
449,Anthony Tolliver\tollian01,PF,32,DET,50,6,1061,124,274,.453,90,217,.415,34,57,.596,.617,60,75,.800,27,116,143,60,17,13,43,86,398
450,Karl-Anthony Towns\townska01,C,22,MIN,57,57,2007,426,779,.547,87,203,.429,339,576,.589,.603,206,244,.844,166,527,693,130,46,82,113,189,1145
451,P.J. Tucker\tuckepj01,SF,32,HOU,53,5,1468,97,255,.380,59,170,.347,38,85,.447,.496,34,42,.810,58,254,312,45,52,13,46,143,287
452,Evan Turner\turneev01,SF,29,POR,52,28,1380,178,392,.454,25,80,.313,153,312,.490,.486,60,71,.845,21,156,177,116,34,17,74,108,441
453,Myles Turner\turnemy01,C,21,IND,39,36,1098,196,399,.491,34,97,.351,162,302,.536,.534,99,132,.750,47,205,252,59,20,83,64,111,525
454,Ekpe Udoh\udohek01,C,30,UTA,46,3,711,55,104,.529,0,0,,55,104,.529,.529,41,54,.759,59,68,127,48,37,62,14,89,151
455,Tyler Ulis\ulisty01,PG,22,PHO,55,37,1249,146,387,.377,26,100,.260,120,287,.418,.411,58,72,.806,15,72,87,218,56,4,88,94,376
456,Jonas Valanciunas\valanjo01,C,25,TOR,50,50,1087,235,419,.561,18,39,.462,217,380,.571,.582,109,130,.838,118,301,419,48,19,37,72,134,597
457,Denzel Valentine\valende01,SG,24,CHI,53,31,1487,202,479,.422,97,253,.383,105,226,.465,.523,26,32,.813,34,249,283,165,40,8,61,130,527
458,Fred VanVleet\vanvlfr01,PG,23,TOR,51,0,956,146,340,.429,61,151,.404,85,189,.450,.519,52,60,.867,15,106,121,153,45,10,46,89,405
459,Rashad Vaughn\vaughra01,SG,21,TOT,23,0,177,21,50,.420,13,35,.371,8,15,.533,.550,4,6,.667,2,15,17,13,4,3,4,13,59
459,Rashad Vaughn\vaughra01,SG,21,MIL,22,0,173,21,50,.420,13,35,.371,8,15,.533,.550,4,6,.667,2,15,17,12,4,3,4,12,59
459,Rashad Vaughn\vaughra01,SG,21,BRK,1,0,4,0,0,,0,0,,0,0,,,0,0,,0,0,0,1,0,0,0,1,0
460,Noah Vonleh\vonleno01,PF,22,POR,33,12,476,47,96,.490,2,6,.333,45,90,.500,.500,23,31,.742,35,132,167,13,6,11,15,42,119
461,Nikola Vucevic\vucevni01,C,27,ORL,34,34,1018,248,505,.491,48,140,.343,200,365,.548,.539,46,56,.821,61,254,315,112,35,38,64,83,590
462,Dwyane Wade\wadedw01,SG,36,CLE,46,3,1069,198,435,.455,23,70,.329,175,365,.479,.482,94,134,.701,39,142,181,163,43,32,91,84,513
463,Dion Waiters\waitedi01,SG,26,MIA,30,30,918,163,410,.398,52,170,.306,111,240,.463,.461,51,69,.739,8,69,77,113,23,9,70,61,429
464,Kemba Walker\walkeke02,PG,27,CHO,52,52,1825,396,930,.426,147,395,.372,249,535,.465,.505,256,301,.850,22,153,175,300,62,17,116,72,1195
465,John Wall\walljo01,PG,27,WAS,37,37,1269,252,604,.417,53,148,.358,199,456,.436,.461,159,221,.719,20,112,132,343,49,42,133,69,716
466,Tyrone Wallace\wallaty01,PG,23,LAC,15,10,463,61,129,.473,7,20,.350,54,109,.495,.500,40,52,.769,10,43,53,38,14,7,24,47,169
467,Taurean Waller-Prince\princta02,SF,23,ATL,55,55,1656,248,580,.428,102,255,.400,146,325,.449,.516,81,99,.818,37,232,269,128,51,30,120,113,679
468,Derrick Walton\waltode01,PG,22,MIA,14,0,137,8,24,.333,7,17,.412,1,7,.143,.479,4,4,1.000,1,11,12,15,5,3,2,6,27
469,T.J. Warren\warretj01,SF,24,PHO,53,53,1714,427,854,.500,16,79,.203,411,775,.530,.509,162,215,.753,95,177,272,75,55,33,72,117,1032
470,James Webb\webbja01,SF,24,BRK,7,0,98,5,19,.263,4,15,.267,1,4,.250,.368,0,0,,7,14,21,3,1,0,3,9,14
471,Briante Weber\weberbr01,PG,25,HOU,13,0,118,9,22,.409,4,9,.444,5,13,.385,.500,4,4,1.000,3,15,18,13,10,3,7,18,26
472,David West\westda01,C,37,GSW,51,0,688,158,260,.608,3,7,.429,155,253,.613,.613,40,55,.727,46,129,175,96,34,56,54,79,359
473,Russell Westbrook\westbru01,PG,29,OKC,55,55,1986,530,1190,.445,74,243,.305,456,947,.482,.476,271,378,.717,94,420,514,566,108,10,255,130,1405
474,Derrick White\whitede01,PG,23,SAS,14,0,90,8,16,.500,4,6,.667,4,10,.400,.625,7,12,.583,4,11,15,6,3,2,6,6,27
475,Okaro White\whiteok01,PF,25,MIA,6,4,80,7,16,.438,4,11,.364,3,5,.600,.563,2,3,.667,3,8,11,2,1,1,1,6,20
476,Isaiah Whitehead\whiteis01,PG,22,BRK,14,0,175,38,81,.469,7,16,.438,31,65,.477,.512,13,19,.684,4,22,26,20,8,2,24,22,96
477,Hassan Whiteside\whiteha01,C,28,MIA,36,36,927,213,387,.550,2,2,1.000,211,385,.548,.553,86,118,.729,111,318,429,29,24,60,63,80,514
478,Andrew Wiggins\wiggian01,SF,22,MIN,57,57,2059,398,906,.439,79,243,.325,319,663,.481,.483,145,229,.633,57,181,238,103,65,36,93,108,1020
479,Jacob Wiley\wileyja01,PF,23,BRK,5,0,33,1,4,.250,1,2,.500,0,2,.000,.375,1,2,.500,2,9,11,2,1,0,0,4,4
480,Damien Wilkins\wilkida02,SF,38,IND,19,1,152,13,39,.333,4,18,.222,9,21,.429,.385,3,4,.750,5,11,16,9,2,1,5,7,33
481,C.J. Williams\willicj01,SG,27,LAC,28,13,544,67,145,.462,21,60,.350,46,85,.541,.534,11,14,.786,10,33,43,24,24,13,16,50,166
482,Lou Williams\willilo02,SG,31,LAC,51,14,1657,377,859,.439,143,376,.380,234,483,.484,.522,289,321,.900,25,103,128,270,56,11,150,71,1186
483,Marvin Williams\willima02,PF,31,CHO,50,50,1301,167,348,.480,81,185,.438,86,163,.528,.596,60,69,.870,47,191,238,58,33,19,39,79,475
484,Matt Williams\willima05,SG,24,MIA,3,0,11,2,6,.333,1,5,.200,1,1,1.000,.417,0,0,,0,1,1,0,0,0,1,1,5
485,Troy Williams\willitr02,SF,23,HOU,4,0,17,2,9,.222,0,5,.000,2,4,.500,.222,1,3,.333,1,3,4,1,1,0,1,2,5
486,D.J. Wilson\wilsodj01,PF,21,MIL,18,0,60,7,12,.583,2,5,.400,5,7,.714,.667,0,0,,1,6,7,2,1,1,4,5,16
487,Jamil Wilson\wilsoja02,SF,27,LAC,15,10,274,38,81,.469,27,63,.429,11,18,.611,.636,2,4,.500,3,29,32,10,5,8,8,34,105
488,Justise Winslow\winslju01,SF,21,MIA,41,18,961,104,254,.409,24,60,.400,80,194,.412,.457,33,48,.688,38,183,221,85,24,19,48,82,265
489,Jeff Withey\witheje01,C,27,DAL,10,0,39,6,16,.375,2,10,.200,4,6,.667,.438,1,2,.500,1,9,10,0,0,3,2,3,15
490,Nate Wolters\woltena01,PG,26,UTA,5,0,19,1,6,.167,0,0,,1,6,.167,.167,0,0,,1,1,2,1,0,0,0,1,2
491,Brandan Wright\wrighbr03,PF,30,MEM,27,1,366,57,99,.576,0,0,,57,99,.576,.576,21,33,.636,32,61,93,13,13,25,8,29,135
492,Delon Wright\wrighde01,PG,25,TOR,42,3,898,129,272,.474,33,88,.375,96,184,.522,.535,70,81,.864,30,100,130,109,46,21,54,47,361
493,Guerschon Yabusele\yabusgu01,PF,22,BOS,22,0,110,13,32,.406,8,22,.364,5,10,.500,.531,5,9,.556,12,19,31,6,1,1,6,14,39
494,James Young\youngja01,SG,22,PHI,5,0,52,4,12,.333,3,10,.300,1,2,.500,.458,4,6,.667,0,2,2,2,0,0,0,3,15
495,Joe Young\youngjo01,PG,25,IND,38,1,358,54,117,.462,16,43,.372,38,74,.514,.530,18,25,.720,6,29,35,22,8,1,16,22,142
496,Nick Young\youngni01,SG,32,GSW,53,1,761,125,282,.443,75,192,.391,50,90,.556,.576,21,30,.700,11,53,64,20,23,6,23,61,346
497,Thaddeus Young\youngth01,PF,29,IND,55,55,1796,292,589,.496,46,136,.338,246,453,.543,.535,27,49,.551,108,206,314,113,87,23,69,119,657
498,Cody Zeller\zelleco01,C,25,CHO,23,0,439,54,109,.495,1,1,1.000,53,108,.491,.500,52,71,.732,51,74,125,22,10,21,27,62,161
499,Tyler Zeller\zellety01,C,28,TOT,43,33,709,125,230,.543,10,27,.370,115,203,.567,.565,40,60,.667,63,132,195,28,8,21,38,80,300
499,Tyler Zeller\zellety01,C,28,BRK,42,33,703,125,229,.546,10,26,.385,115,203,.567,.568,40,60,.667,62,131,193,28,8,21,35,78,300
499,Tyler Zeller\zellety01,C,28,MIL,1,0,6,0,1,.000,0,1,.000,0,0,,.000,0,0,,1,1,2,0,0,0,3,2,0
500,Paul Zipser\zipsepa01,SF,23,CHI,44,9,669,67,189,.354,29,83,.349,38,106,.358,.431,12,18,.667,11,98,109,36,16,9,39,66,175
501,Ante Zizic\zizican01,C,21,CLE,12,1,41,4,11,.364,0,0,,4,11,.364,.364,5,7,.714,5,10,15,1,0,3,2,4,13
502,Ivica Zubac\zubaciv01,C,20,LAL,15,0,67,8,21,.381,0,0,,8,21,.381,.381,3,3,1.000,4,11,15,2,0,2,5,8,19
